表示語	解析語
abandoni	abandoni
abandonismo	abandonismo
abandono	abandono
abatiso	abatiso
abazio	abazio
abdukcio	abdukcio
abduktoro	abduktoro
abevilio	abevilio
abiogenezo	abiogenezo
ablacio	ablacio
abnorma	abnorma
abolismo	abolismo
abomaso	abomaso
abortitaĵo	abortitaĵo
abrazia	abrazia
abrazio	abrazio
abrogacii	abrogacii
abrogi	abrogi
abrogo	abrogo
abulio	abulio
abutilo	abutilo
abĵuri	abĵuri
ace	ace
acetabulo	acetabulo
acetili	acetili
acetonemio	acetonemio
acetonilo	acetonilo
acetonurio	acetonurio
acidimetro	acidimetro
acidozo	acidozo
acino	acino
acipensero	acipensero
acipenseroformaj	acipenseroformaj
adamantino	adamantino
adaptometrio	adaptometrio
adenito	adenito
adenoida	adenoida
adenoidismo	adenoidismo
adenoidito	adenoidito
adenomo	adenomo
adenopatio	adenopatio
adenozilo	adenozilo
adenpatio	adenpatio
adipo	adipo
adipogenezo	adipogenezo
adipozo	adipozo
adisona	adisona
adjudanto	adjudanto
adsubstantivo	adsubstantivo
adukcio	adukcio
aduktoro	aduktoro
adulteri	adulteri
advekcio	advekcio
adventico	adventico
adventiva	adventiva
aedo	aedo
aeremio	aeremio
aernetoleranta	aernetoleranta
aerobiko	aerobiko
aeroforo	aeroforo
aerologio	aerologio
aerometrio	aerometrio
afanipteroj	afanipteroj
aferezo	aferezo
afidavito	afidavito
afidedoj	afidedoj
afikŝo	afikŝo
afinacii	afinacii
afinacio	afinacio
afineco	afineco
afiso	afiso
agamedoj	agamedoj
agamia	agamia
agamio	agamio
agaro	agaro
agatido	agatido
agenturo	agenturo
agerato	agerato
aglutinino	aglutinino
agnozio	agnozio
agoro	agoro
agrafilo	agrafilo
agrafio	agrafio
agreŝi	agreŝi
agutio	agutio
agvarao	agvarao
ahimsa	ahimsa
ahimsano	ahimsano
ahimso	ahimso
aidoŝo	aidoŝo
airo	airo
aizoacoj	aizoacoj
aizoo	aizoo
ajapano	ajapano
ajatolo	ajatolo
aji	aji
akada	akada
akantiaso	akantiaso
akantocefaloj	akantocefaloj
akantopterigoj	akantopterigoj
akarozo	akarozo
akcidenca	akcidenca
akcidenco	akcidenco
akcipitredoj	akcipitredoj
akebio	akebio
akenaro	akenaro
akeno	akeno
akeo	akeo
akerontio	akerontio
akinezio	akinezio
akmeo	akmeo
akneo	akneo
akolio	akolio
akolito	akolito
akonitino	akonitino
akontio	akontio
akorio	akorio
akoro	akoro
akrocefala	akrocefala
akrocefalo	akrocefalo
akrocianozo	akrocianozo
akroleino	akroleino
akromatopsia	akromatopsia
akromegalio	akromegalio
akromio	akromio
akroĥordo	akroĥordo
aksiometro	aksiometro
aksoido	aksoido
aksono	aksono
akteo	akteo
aktinidibero	aktinidibero
aktinidio	aktinidio
aktiniidoj	aktiniidoj
aktinistoj	aktinistoj
aktinolito	aktinolito
aktinomiceto	aktinomiceto
aktinomicetoj	aktinomicetoj
aktinomicetozo	aktinomicetozo
aktinopterigoj	aktinopterigoj
aktualismo	aktualismo
akuŝologio	akuŝologio
akvifoliacoj	akvifoliacoj
akvifolio	akvifolio
alambiko	alambiko
alando	alando
alanino	alanino
alantoido	alantoido
alaterno	alaterno
alaŭdedoj	alaŭdedoj
albedo	albedo
albigenso	albigenso
albito	albito
albizio	albizio
albugineito	albugineito
albugineo	albugineo
albugo	albugo
albumozo	albumozo
alcededoj	alcededoj
alcelafo	alcelafo
alcionio	alcionio
alcioniuloj	alcioniuloj
aldolo	aldolo
aldosterono	aldosterono
aleatora	aleatora
aleksino	aleksino
aleksio	aleksio
alektoro	alektoro
alelo	alelo
alero	alero
aleŭrito	aleŭrito
aleŭrodedoj	aleŭrodedoj
aleŭrodo	aleŭrodo
algida	algida
algideco	algideco
alginato	alginato
algino	algino
algio	algio
algiologio	algiologio
algiologo	algiologo
algologio	algologio
algologo	algologo
algonkio	algonkio
algvazilo	algvazilo
aliario	aliario
alidado	alidado
aliel	aliel
aliena	aliena
alieneco	alieneco
alieni	alieni
alienisto	alienisto
alienulo	alienulo
alies	alies
alifata	alifata
alilo	alilo
alismacoj	alismacoj
alismo	alismo
alito	alito
aliumo	aliumo
alizarino	alizarino
alizeo	alizeo
alizujo	alizujo
alk	alk
alkadieno	alkadieno
alkado	alkado
alkaja	alkaja
alkalio	alkalio
alkalometrio	alkalometrio
alkalozo	alkalozo
alkanalo	alkanalo
alkano	alkano
alkanolato	alkanolato
alkanolo	alkanolo
alkanono	alkanono
alkarazo	alkarazo
alkazabo	alkazabo
alkazaro	alkazaro
alkekengo	alkekengo
alkeno	alkeno
alkilo	alkilo
alkoholato	alkoholato
alkoholaturo	alkoholaturo
alkoholemio	alkoholemio
almandino	almandino
almeo	almeo
almo	almo
alodo	alodo
alokazio	alokazio
aloktono	aloktono
alomorfo	alomorfo
aloritmio	aloritmio
alotrofio	alotrofio
alotropa	alotropa
alotropaĵo	alotropaĵo
alotropeco	alotropeco
alpinio	alpinio
alpismo	alpismo
alt	alt
alteracii	alteracii
alteraciiĝi	alteraciiĝi
alteracio	alteracio
alterneco	alterneco
altimetro	altimetro
altometrio	altometrio
aluato	aluato
aluminato	aluminato
aluminiato	aluminiato
alunerco	alunerco
aluntero	aluntero
alveolinedoj	alveolinedoj
alveolino	alveolino
alzano	alzano
alĝebro	alĝebro
alĝo	alĝo
amando	amando
amanitino	amanitino
amarilidacoj	amarilidacoj
amaŭrozo	amaŭrozo
ambistomo	ambistomo
ambivalenco	ambivalenco
ambliopa	ambliopa
ambliopeco	ambliopeco
amblistomo	amblistomo
ambrosio	ambrosio
ambulanĉo	ambulanĉo
ambulatoria	ambulatoria
ambulatorio	ambulatorio
amebeco	amebeco
amebismo	amebismo
amebozo	amebozo
amelanĉo	amelanĉo
amelozo	amelozo
ameno	ameno
amenoreo	amenoreo
amentuloj	amentuloj
ametropeco	ametropeco
amfetamino	amfetamino
amfiartro	amfiartro
amfibolito	amfibolito
amfibologio	amfibologio
amfineŭroj	amfineŭroj
amfiokso	amfiokso
amfipodoj	amfipodoj
amfotera	amfotera
amianto	amianto
amigdalino	amigdalino
amikto	amikto
amilazo	amilazo
amio	amio
amirido	amirido
amitozo	amitozo
amiŝo	amiŝo
amniuloj	amniuloj
amofilo	amofilo
ampeloprazo	ampeloprazo
amplifa	amplifa
amplifilo	amplifilo
amplifo	amplifo
anabaptisto	anabaptisto
anafazo	anafazo
anafora	anafora
anaforo	anaforo
anaglifa	anaglifa
anaglifo	anaglifo
anakardiacoj	anakardiacoj
anakinezio	anakinezio
anakoreto	anakoreto
analeptiko	analeptiko
analgeziko	analgeziko
analisto	analisto
anamirto	anamirto
anamorfoza	anamorfoza
anamorfozo	anamorfozo
anao	anao
anasedoj	anasedoj
anastatiko	anastatiko
anastomoza	anastomoza
anastomozi	anastomozi
anastomozo	anastomozo
anastrofo	anastrofo
anateksito	anateksito
anatekso	anatekso
anatoksino	anatoksino
ancilostomo	ancilostomo
ancilostomozo	ancilostomozo
androceo	androceo
andropogono	andropogono
androzaco	androzaco
andujeto	andujeto
andujo	andujo
aneksismo	aneksismo
anekŝi	anekŝi
anemometrio	anemometrio
anetolo	anetolo
aneŭploida	aneŭploida
angiito	angiito
angiologio	angiologio
angiomo	angiomo
angiotensino	angiotensino
anglezo	anglezo
anglicismo	anglicismo
angulilo	angulilo
angulumita	angulumita
anhidrido	anhidrido
anhidrito	anhidrito
anilido	anilido
anilo	anilo
anizidino	anizidino
anizokorio	anizokorio
anizosfigmio	anizosfigmio
ankoneo	ankoneo
ankoraŭa	ankoraŭa
ankrizita	ankrizita
anksia	anksia
anksio	anksio
anobiedoj	anobiedoj
anodonto	anodonto
anoksemio	anoksemio
anoksio	anoksio
anono	anono
anopsio	anopsio
anoreksio	anoreksio
anortito	anortito
anosmio	anosmio
anstataŭilo	anstataŭilo
antecedentoj	antecedentoj
antedono	antedono
antefikso	antefikso
antenario	antenario
anteridio	anteridio
anterozoido	anterozoido
anthelio	anthelio
anti	anti
antiklinalo	antiklinalo
antilido	antilido
antociano	antociano
antonomazio	antonomazio
antozooj	antozooj
antraceno	antraceno
antrakinono	antrakinono
antrakozo	antrakozo
antrisko	antrisko
antro	antro
antropofagismo	antropofagismo
antropofago	antropofago
anturio	anturio
anuitato	anuitato
anurio	anurio
anuroj	anuroj
anuŝo	anuŝo
anzuarbo	anzuarbo
anzuo	anzuo
anzuujo	anzuujo
aortito	aortito
aoto	aoto
apatosaŭro	apatosaŭro
apeksa	apeksa
apekso	apekso
apendicektomio	apendicektomio
apendikularioj	apendikularioj
apepsio	apepsio
apercepti	apercepti
apercepto	apercepto
apetaloj	apetaloj
apetenco	apetenco
apiolo	apiolo
apioso	apioso
aplito	aplito
apocinacoj	apocinacoj
apocino	apocino
apodoformaj	apodoformaj
apoloĝo	apoloĝo
apomikso	apomikso
aponeŭrozo	aponeŭrozo
aposiopezo	aposiopezo
apotecio	apotecio
apretanto	apretanto
apretaĵo	apretaĵo
aproksimi	aproksimi
arabidopso	arabidopso
arabinozo	arabinozo
arabiso	arabiso
aragonito	aragonito
arahanto	arahanto
araknoidito	araknoidito
aramea	aramea
araneoidoj	araneoidoj
arbarizi	arbarizi
arbologio	arbologio
ardeedoj	ardeedoj
arekacoj	arekacoj
areknukso	areknukso
areko	areko
arenario	arenario
areola	areola
areolo	areolo
arganio	arganio
argemono	argemono
argilpetro	argilpetro
arginino	arginino
argiopo	argiopo
argironeto	argironeto
arida	arida
arilo	arilo
arino	arino
aritenoido	aritenoido
aritmetikilo	aritmetikilo
arkaa	arkaa
arkaaĵo	arkaaĵo
arkaiĝi	arkaiĝi
arkeano	arkeano
arkegonio	arkegonio
arkeoloĝo	arkeoloĝo
arkeozoiko	arkeozoiko
arketipo	arketipo
arkimandrito	arkimandrito
arkipelaĝo	arkipelaĝo
arkipteroj	arkipteroj
arkiteŭto	arkiteŭto
arkivolto	arkivolto
arkozo	arkozo
arkteo	arkteo
arktostafilo	arktostafilo
arkuso	arkuso
armadelo	armadelo
armadilidio	armadilidio
armilario	armilario
armorio	armorio
aromata	aromata
arondismento	arondismento
arsacetino	arsacetino
arsenido	arsenido
arsino	arsino
artefakto	artefakto
arteriektomio	arteriektomio
arteriito	arteriito
artokarpo	artokarpo
artralgio	artralgio
artro	artro
artrologio	artrologio
arumacoj	arumacoj
arumano	arumano
arundo	arundo
arunko	arunko
arĝentumo	arĝentumo
arĥaja	arĥaja
arĥipelaĝo	arĥipelaĝo
asbestozo	asbestozo
ascensio	ascensio
ascidioj	ascidioj
ascito	ascito
asdiko	asdiko
asembli	asembli
asidua	asidua
asindeto	asindeto
asiriologio	asiriologio
asistolio	asistolio
askaridozo	askaridozo
asklepiadacoj	asklepiadacoj
asko	asko
askomicetoj	askomicetoj
askomikotoj	askomikotoj
askorba	askorba
askujo	askujo
asonanĉo	asonanĉo
asparagino	asparagino
aspartato	aspartato
asparto	asparto
aspergilozo	aspergilozo
asperĝi	asperĝi
aspidistro	aspidistro
aspiko	aspiko
aspiratoro	aspiratoro
asplenio	asplenio
astenosfero	astenosfero
asteriedoj	asteriedoj
asterioidoj	asterioidoj
asterolino	asterolino
asterozooj	asterozooj
astilbo	astilbo
astreo	astreo
atamano	atamano
ataraksio	ataraksio
ateliero	ateliero
ateneo	ateneo
atenuilo	atenuilo
ateromo	ateromo
aterosklerozo	aterosklerozo
atikito	atikito
atlaŝo	atlaŝo
atmano	atmano
atmo	atmo
atmometro	atmometro
atmosferografio	atmosferografio
atmosferologio	atmosferologio
atonala	atonala
atrabilo	atrabilo
atrezio	atrezio
atribŭi	atribŭi
atricio	atricio
atropismo	atropismo
atropo	atropo
avenŭo	avenŭo
averoo	averoo
avicenio	avicenio
avikulario	avikulario
avinjo	avinjo
avio	avio
avitaminozo	avitaminozo
aza	aza
azarolo	azarolo
azelo	azelo
azeotropo	azeotropo
azido	azido
azidotimidino	azidotimidino
azimeno	azimeno
azoa	azoa
azoiko	azoiko
azoksio	azoksio
azolo	azolo
azoo	azoo
azotemio	azotemio
azoturio	azoturio
azteko	azteko
azuleĥo	azuleĥo
aĥerontio	aĥerontio
aĥi	aĥi
aŝaro	aŝaro
aŭbado	aŭbado
aŭbrietio	aŭbrietio
aŭdienĉo	aŭdienĉo
aŭditoro	aŭditoro
aŭgito	aŭgito
aŭgmentativo	aŭgmentativo
aŭgmento	aŭgmento
aŭgustenano	aŭgustenano
aŭkedoj	aŭkedoj
aŭksino	aŭksino
aŭksotrofa	aŭksotrofa
aŭkubo	aŭkubo
aŭkumeo	aŭkumeo
aŭrelio	aŭrelio
aŭriko	aŭriko
aŭrikulario	aŭrikulario
aŭripigmento	aŭripigmento
aŭstera	aŭstera
aŭstrala	aŭstrala
aŭstralopiteko	aŭstralopiteko
aŭtarkio	aŭtarkio
aŭtigena	aŭtigena
aŭtogamio	aŭtogamio
aŭtogena	aŭtogena
aŭtomorfio	aŭtomorfio
aŭtosomo	aŭtosomo
aŭtotrofa	aŭtotrofa
baci	baci
baco	baco
bagno	bagno
bagro	bagro
bajronismo	bajronismo
bakango	bakango
baktericida	baktericida
baktericido	baktericido
bakteriofaĝo	bakteriofaĝo
bakŝiŝo	bakŝiŝo
balafono	balafono
balanito	balanito
balantidio	balantidio
balato	balato
balenedoj	balenedoj
balenopteredoj	balenopteredoj
balenoptero	balenoptero
baloteo	baloteo
balzaminacoj	balzaminacoj
bambuzo	bambuzo
banderilo	banderilo
bandoliero	bandoliero
bangificoj	bangificoj
bangio	bangio
bangioficoj	bangioficoj
bantua	bantua
banusejo	banusejo
banuslando	banuslando
banuso	banuso
baptanino	baptanino
baptisterio	baptisterio
baptujo	baptujo
barbadenbero	barbadenbero
barbadeno	barbadeno
barbakano	barbakano
barbio	barbio
barbitono	barbitono
barbitura	barbitura
barbituraĵo	barbituraĵo
barbiturismo	barbiturismo
barbituro	barbituro
bariono	bariono
barumo	barumo
barzojo	barzojo
basiero	basiero
batava	batava
batokroma	batokroma
batolito	batolito
batometrio	batometrio
batometro	batometro
batui	batui
batuisto	batuisto
batuo	batuo
bavuro	bavuro
bazamento	bazamento
bazidimicetoj	bazidimicetoj
bazidimikotoj	bazidimikotoj
bazidio	bazidio
bazidiomicetoj	bazidiomicetoj
bazidiomikotoj	bazidiomikotoj
bazidiujo	bazidiujo
bazoĉo	bazoĉo
baŝkiro	baŝkiro
baŝliko	baŝliko
baŝo	baŝo
baŭhinio	baŭhinio
bearnezo	bearnezo
bedelio	bedelio
begamo	begamo
behaviorismo	behaviorismo
bei	bei
beja	beja
bejo	bejo
bekabungo	bekabungo
bekeŝo	bekeŝo
belemnitoj	belemnitoj
beliso	beliso
belono	belono
belonoformaj	belonoformaj
beloto	beloto
belĝo	belĝo
bemerio	bemerio
benta	benta
bentano	bentano
bento	bento
bentulo	bentulo
benzidino	benzidino
benzilo	benzilo
benzo	benzo
benzodiazepino	benzodiazepino
benzoili	benzoili
benzoilo	benzoilo
bermo	bermo
bernardanoj	bernardanoj
berserko	berserko
bertoletio	bertoletio
bestia	bestia
bestio	bestio
bezoaroj	bezoaroj
beŝamelo	beŝamelo
bi	bi
biasa	biasa
biasi	biasi
biaso	biaso
bidento	bidento
bielo	bielo
bienalo	bienalo
bierumi	bierumi
bifaco	bifaco
bifadena	bifadena
bifenilo	bifenilo
bifida	bifida
bifilara	bifilara
bigarado	bigarado
bigaradujo	bigaradujo
bigarelarbo	bigarelarbo
bigarelo	bigarelo
bigarelujo	bigarelujo
bignonio	bignonio
bikso	bikso
bilabialo	bilabialo
bilanĉo	bilanĉo
bilharziozo	bilharziozo
bimetala	bimetala
biocido	biocido
bioloĝo	bioloĝo
biometrio	biometrio
biomo	biomo
bionto	bionto
biopsio	biopsio
biotino	biotino
biotito	biotito
birgo	birgo
bisako	bisako
biskutelo	biskutelo
bismutato	bismutato
bistorto	bistorto
bitniko	bitniko
bitumoza	bitumoza
biureto	biureto
bizanto	bizanto
bizo	bizo
biĵuterio	biĵuterio
blablai	blablai
blakbaso	blakbaso
blamanĝo	blamanĝo
blapto	blapto
blastemo	blastemo
blasto	blasto
blastocero	blastocero
blastodermo	blastodermo
blastomiceto	blastomiceto
blastomicetoj	blastomicetoj
blastomicetozo	blastomicetozo
blastulo	blastulo
blatuloj	blatuloj
blazego	blazego
blaziga	blaziga
blazo	blazo
blefarito	blefarito
blenioidoj	blenioidoj
bletio	bletio
blezi	blezi
blinki	blinki
blinkigi	blinkigi
blinkilo	blinkilo
blinko	blinko
blino	blino
blizardo	blizardo
bluso	bluso
bluti	bluti
boaĉo	boaĉo
bobo	bobo
bobolinko	bobolinko
bodonio	bodonio
bogomilano	bogomilano
bogomilismo	bogomilismo
bojaro	bojaro
bokaĉeska	bokaĉeska
boksero	boksero
bokŝi	bokŝi
boldino	boldino
boldo	boldo
boletacoj	boletacoj
bolometro	bolometro
bombako	bombako
bombeno	bombeno
bombinatoro	bombinatoro
bonedo	bonedo
bongoj	bongoj
bonifiko	bonifiko
bonito	bonito
bonsajo	bonsajo
bonto	bonto
bopo	bopo
bopso	bopso
boragacoj	boragacoj
borano	borano
borborigmo	borborigmo
borduna	borduna
borduno	borduno
boreala	boreala
borelio	borelio
borneolo	borneolo
borpinto	borpinto
bosanovo	bosanovo
bosaĵo	bosaĵo
boselafo	boselafo
bosi	bosi
boso	boso
bostriko	bostriko
bosvelio	bosvelio
botanikumi	botanikumi
botargo	botargo
botrito	botrito
bovedoj	bovedoj
bovisteo	bovisteo
bradikardio	bradikardio
bradipedoj	bradipedoj
bradipepsio	bradipepsio
brahmoo	brahmoo
brakino	brakino
brakiopodoj	brakiopodoj
brankiopodoj	brankiopodoj
brankiostomo	brankiostomo
branĉido	branĉido
braĉo	braĉo
braĥino	braĥino
braĥiuro	braĥiuro
bregmo	bregmo
bremŝo	bremŝo
breveto	breveto
brevo	brevo
brezaĵo	brezaĵo
brezi	brezi
brezujo	brezujo
breĉio	breĉio
brifitoj	brifitoj
brikabrako	brikabrako
brio	brio
briopsidoj	briopsidoj
briozooj	briozooj
brioĉo	brioĉo
brisuro	brisuro
brisurumita	brisurumita
britona	britona
brokatelo	brokatelo
bromelio	bromelio
bromuso	bromuso
bronkoskopio	bronkoskopio
bronkoskopo	bronkoskopo
brosmo	brosmo
brucelozoj	brucelozoj
brucino	brucino
bruliva	bruliva
brumo	brumo
brunfelsio	brunfelsio
brunjono	brunjono
brusonetio	brusonetio
brutte	brutte
buadi	buadi
budleo	budleo
bufono	bufono
buftalmo	buftalmo
buglo	buglo
bugri	bugri
bujabeso	bujabeso
bukcinatoro	bukcinatoro
bukmekro	bukmekro
bukoliko	bukoliko
bukorako	bukorako
bukŝo	bukŝo
bulimio	bulimio
bullo	bullo
bungaro	bungaro
bupleŭro	bupleŭro
bupresto	bupresto
burasko	burasko
burgo	burgo
burjato	burjato
burko	burko
burnuŝo	burnuŝo
burseracoj	burseracoj
bursero	bursero
bursito	bursito
burso	burso
but	but
butadieno	butadieno
butanono	butanono
buteno	buteno
butino	butino
butomo	butomo
buĝio	buĝio
buĥto	buĥto
cebedoj	cebedoj
cebo	cebo
cecidomio	cecidomio
cefala	cefala
cefalaspido	cefalaspido
cefalaspidoformaj	cefalaspidoformaj
cefalaspidomorfoj	cefalaspidomorfoj
cefaleo	cefaleo
cefalo	cefalo
ceibo	ceibo
celaro	celaro
celeco	celeco
celentero	celentero
celestito	celestito
celesto	celesto
celobiozo	celobiozo
celomo	celomo
celomuloj	celomuloj
celtido	celtido
cenobito	cenobito
cenocito	cenocito
censi	censi
censisto	censisto
centaŭrio	centaŭrio
centifolio	centifolio
centilo	centilo
centipelio	centipelio
centraliza	centraliza
centrifugado	centrifugado
centriolo	centriolo
centromero	centromero
centrosomo	centrosomo
centuriestro	centuriestro
centurio	centurio
cenzoro	cenzoro
cepolo	cepolo
cerambikedoj	cerambikedoj
cerambiko	cerambiko
ceramio	ceramio
cerastio	cerastio
ceratino	ceratino
ceratofilo	ceratofilo
ceratonio	ceratonio
cerbatano	cerbatano
cercidifilo	cercidifilo
cercido	cercido
cerebro	cerebro
cerkario	cerkario
cerkopitekedoj	cerkopitekedoj
cerkopiteko	cerkopiteko
certio	certio
ceruzito	ceruzito
cervelaso	cervelaso
cesto	cesto
cestodoj	cestodoj
cestro	cestro
ceterako	ceterako
cetilo	cetilo
cetrario	cetrario
cezalpinio	cezalpinio
cezara	cezara
cezari	cezari
cgs	cgs
cianato	cianato
cianeo	cianeo
cianfitoj	cianfitoj
cianhidrino	cianhidrino
cianofitoj	cianofitoj
cianokobalamino	cianokobalamino
cianorato	cianorato
cianorito	cianorito
cianozo	cianozo
cianuro	cianuro
ciborio	ciborio
cicoida	cicoida
cifoskoliozo	cifoskoliozo
cifozo	cifozo
cikadomorfoj	cikadomorfoj
cikaso	cikaso
ciklometria	ciklometria
ciklosporino	ciklosporino
ciklostomoj	ciklostomoj
ciliaro	ciliaro
ciliuloj	ciliuloj
cimbalario	cimbalario
cimbidio	cimbidio
cimbopogono	cimbopogono
cimbro	cimbro
cimicifugo	cimicifugo
cimitaro	cimitaro
cinamalo	cinamalo
cinamomo	cinamomo
cinaro	cinaro
cindropetro	cindropetro
cingulo	cingulo
cinipedoj	cinipedoj
cinipo	cinipo
cinkledoj	cinkledoj
cinocefalo	cinocefalo
cinodonto	cinodonto
cinogloso	cinogloso
cinozuro	cinozuro
cintri	cintri
cintro	cintro
cinturo	cinturo
cipero	cipero
cipo	cipo
cipreo	cipreo
ciprinedoj	ciprinedoj
cipripedio	cipripedio
circeo	circeo
cirkaeto	cirkaeto
cirkonvalacio	cirkonvalacio
cirkumflekŝo	cirkumflekŝo
cirsio	cirsio
cisteino	cisteino
cisticerko	cisticerko
cisticerkozo	cisticerkozo
cistino	cistino
cistocelo	cistocelo
cistopterido	cistopterido
cistrono	cistrono
citino	citino
citofilakto	citofilakto
citokinino	citokinino
citokromo	citokromo
citologio	citologio
citologo	citologo
citoskeleto	citoskeleto
citosolo	citosolo
citotropa	citotropa
citozino	citozino
citozo	citozo
citralo	citralo
citrolino	citrolino
citronelalo	citronelalo
citronelo	citronelo
ciumi	ciumi
civetikto	civetikto
ciĉo	ciĉo
cumeca	cumeca
cumo	cumo
dabi	dabi
dabingo	dabingo
dadaisto	dadaisto
dagerotipio	dagerotipio
dajmonismo	dajmonismo
dajmono	dajmono
dakrioadenito	dakrioadenito
dakriocistito	dakriocistito
dakriocisto	dakriocisto
daktiliso	daktiliso
daktiloskopio	daktiloskopio
dalbergio	dalbergio
daltonulo	daltonulo
damaro	damaro
datenopo	datenopo
davalio	davalio
dazipedoj	dazipedoj
dazipodedoj	dazipodedoj
daŭfeno	daŭfeno
daŭko	daŭko
debila	debila
debileco	debileco
debiliga	debiliga
defensejo	defensejo
defensi	defensi
defeti	defeti
defetisto	defetisto
deikto	deikto
dejo	dejo
dekadenĉo	dekadenĉo
dekalino	dekalino
dekapodoj	dekapodoj
dekati	dekati
dekatlono	dekatlono
dekilo	dekilo
dekubito	dekubito
delekti	delekti
delektinda	delektinda
delektiĝi	delektiĝi
deleĝi	deleĝi
deliktinto	deliktinto
deloniko	deloniko
deltametalo	deltametalo
deltaplano	deltaplano
demagoĝo	demagoĝo
demimondo	demimondo
demiurgo	demiurgo
demodekso	demodekso
demodeksozo	demodeksozo
demonologio	demonologio
dendrito	dendrito
dendrokronologio	dendrokronologio
dendrokronologo	dendrokronologo
dendrolago	dendrolago
dendrologio	dendrologio
dengo	dengo
denotacio	denotacio
densometrio	densometrio
denstetio	denstetio
dentino	dentino
dentizi	dentizi
dentizilo	dentizilo
dentumita	dentumita
dentumo	dentumo
deodaro	deodaro
deoksi	deoksi
deontologio	deontologio
deploji	deploji
depravacio	depravacio
deprecado	deprecado
depreci	depreci
depreco	depreco
depresia	depresia
depresora	depresora
dermapteroj	dermapteroj
dermato	dermato
dermesto	dermesto
dermopteroj	dermopteroj
dero	dero
desapontiĝi	desapontiĝi
desmosomo	desmosomo
despero	despero
detempro	detempro
detonaciigi	detonaciigi
detonaciigilo	detonaciigilo
detonaciivo	detonaciivo
detrita	detrita
detrito	detrito
deviaciismo	deviaciismo
deviacio	deviacio
dezajni	dezajni
dezajnisto	dezajnisto
dezajno	dezajno
deŭteromicetoj	deŭteromicetoj
di	di
diafanoskopio	diafanoskopio
diagenezo	diagenezo
diagnostiko	diagnostiko
diagnoziko	diagnoziko
diaklazo	diaklazo
diakrita	diakrita
diakrona	diakrona
dialefo	dialefo
dialipetaloj	dialipetaloj
dialoĝo	dialoĝo
diapaŭzo	diapaŭzo
diapedezo	diapedezo
diapsidoj	diapsidoj
diasporo	diasporo
diastrofismo	diastrofismo
diatomeoj	diatomeoj
diatomito	diatomito
diazo	diazo
diazometano	diazometano
diazoniigi	diazoniigi
diazonio	diazonio
didaskalio	didaskalio
didelfedoj	didelfedoj
didimo	didimo
dieno	dieno
dieŝo	dieŝo
difenbakio	difenbakio
difeomorfa	difeomorfa
difeomorfia	difeomorfia
difeomorfio	difeomorfio
difeomorfo	difeomorfo
difilobotrio	difilobotrio
diftonĝo	diftonĝo
digamo	digamo
digestujo	digestujo
digitario	digitario
digitoksino	digitoksino
digitopunkturo	digitopunkturo
diglosio	diglosio
digresio	digresio
dikariono	dikariono
dikotiledonoj	dikotiledonoj
dikotoma	dikotoma
dikotomeco	dikotomeco
dikroa	dikroa
dikroeco	dikroeco
dikroismo	dikroismo
diktiosomaro	diktiosomaro
diktiosomo	diktiosomo
dilatatoro	dilatatoro
dilatujo	dilatujo
dilenio	dilenio
diminuendo	diminuendo
diminui	diminui
dimorfa	dimorfa
dimorfeco	dimorfeco
dimorfismo	dimorfismo
diodonto	diodonto
diofanta	diofanta
dioksano	dioksano
diomedeo	diomedeo
dioneo	dioneo
dioptro	dioptro
diorito	diorito
dioskoreino	dioskoreino
dioskoreo	dioskoreo
diospiro	diospiro
diploida	diploida
diplokoko	diplokoko
diplomologio	diplomologio
diploo	diploo
diplopio	diplopio
diplopodoj	diplopodoj
dipnoj	dipnoj
dipodedoj	dipodedoj
diporto	diporto
dipterokarpacoj	dipterokarpacoj
dipterokarpo	dipterokarpo
direktismo	direktismo
dirko	dirko
disaĝio	disaĝio
diselo	diselo
disjunkcio	disjunkcio
diskedo	diskedo
diskomicetoj	diskomicetoj
diskrecio	diskrecio
diskriminilo	diskriminilo
dismenoreo	dismenoreo
dismo	dismo
disoma	disoma
dispneo	dispneo
disproporcio	disproporcio
dista	dista
distanĉo	distanĉo
distribucio	distribucio
distribŭi	distribŭi
ditografio	ditografio
diurezilo	diurezilo
divertikulektomio	divertikulektomio
divertikulo	divertikulo
diverĝeco	diverĝeco
diĝesto	diĝesto
docetismo	docetismo
dodekaedro	dodekaedro
dodekafona	dodekafona
dodekafonio	dodekafonio
dodekafonismo	dodekafonismo
dodoico	dodoico
dogero	dogero
dojno	dojno
dokta	dokta
dolikoto	dolikoto
dolino	dolino
dolio	dolio
doliĥoto	doliĥoto
dolmano	dolmano
dolo	dolo
dolomito	dolomito
dolomitpetro	dolomitpetro
domanio	domanio
domineco	domineco
donacio	donacio
donako	donako
dopantaĵo	dopantaĵo
dopanto	dopanto
dopilo	dopilo
dora	dora
dorido	dorido
dorika	dorika
doriso	doriso
dornumita	dornumita
dorsantaŭa	dorsantaŭa
drabo	drabo
draceno	draceno
drakocefalo	drakocefalo
drakoni	drakoni
draĝeo	draĝeo
drimio	drimio
drimiso	drimiso
driopterido	driopterido
drola	drola
dromiceo	dromiceo
dromio	dromio
dromo	dromo
dropso	dropso
drozofiledoj	drozofiledoj
drumo	drumo
duaro	duaro
dubleo	dubleo
duenjo	duenjo
duflo	duflo
dukdalbo	dukdalbo
dumduma	dumduma
dupo	dupo
durativo	durativo
durio	durio
duteto	duteto
duumviro	duumviro
easto	easto
ebonacoj	ebonacoj
ebulioskopo	ebulioskopo
ecidio	ecidio
ecio	ecio
ecisporo	ecisporo
edentatoj	edentatoj
edilo	edilo
efebo	efebo
efedrino	efedrino
efedro	efedro
efelido	efelido
efemeropteroj	efemeropteroj
efloreskaĵo	efloreskaĵo
efo	efo
efrito	efrito
egilopo	egilopo
egiptologio	egiptologio
ejakula	ejakula
ejakulo	ejakulo
ejektivo	ejektivo
ejgena	ejgena
ejgeno	ejgeno
ejnŝtejnio	ejnŝtejnio
ejŝhornio	ejŝhornio
ekbalio	ekbalio
ekdisono	ekdisono
ekinoidoj	ekinoidoj
ekinokoko	ekinokoko
ekinopso	ekinopso
ekinozooj	ekinozooj
eklektikisto	eklektikisto
eklipŝo	eklipŝo
ekonometriko	ekonometriko
ekranumi	ekranumi
eksceŝo	eksceŝo
ekscizi	ekscizi
eksklamacio	eksklamacio
ekspansiilo	ekspansiilo
ekspektori	ekspektori
ekspektoriga	ekspektoriga
eksplica	eksplica
eksplici	eksplici
ekspresionisto	ekspresionisto
ekspreŝo	ekspreŝo
ekstensanto	ekstensanto
ekstensi	ekstensi
ekstenso	ekstenso
ekstensoro	ekstensoro
eksterejo	eksterejo
ekstradoso	ekstradoso
eksvoto	eksvoto
ektazio	ektazio
ekto	ekto
ektodermo	ektodermo
ektomio	ektomio
ekvipotenciala	ekvipotenciala
ekvipotencialo	ekvipotencialo
ekvizetopsidoj	ekvizetopsidoj
ekvo	ekvo
ekzarko	ekzarko
ekzekutivo	ekzekutivo
ekzistismo	ekzistismo
ekzo	ekzo
ekzogamio	ekzogamio
ekzogena	ekzogena
ekzokrina	ekzokrina
ekzotera	ekzotera
elafro	elafro
elaidato	elaidato
elanio	elanio
elapedoj	elapedoj
elapo	elapo
elasmobrankoj	elasmobrankoj
elastino	elastino
elastomero	elastomero
elateredoj	elateredoj
elateriino	elateriino
elatino	elatino
eledono	eledono
elefantedoj	elefantedoj
elektrebla	elektrebla
elektroforezo	elektroforezo
elektrokuti	elektrokuti
elektrumo	elektrumo
elektuario	elektuario
eleo	eleo
eleokarito	eleokarito
eletario	eletario
elipŝo	elipŝo
elitrigio	elitrigio
elodeo	elodeo
elokucio	elokucio
eluantaĵo	eluantaĵo
eluanto	eluanto
elui	elui
eluitaĵo	eluitaĵo
eluviado	eluviado
eluvii	eluvii
eluvio	eluvio
emberizedoj	emberizedoj
embolozigo	embolozigo
embrifitoj	embrifitoj
embriofitoj	embriofitoj
embriotomio	embriotomio
embritomio	embritomio
embrokacio	embrokacio
emersio	emersio
emetino	emetino
emetropa	emetropa
emidedoj	emidedoj
emigi	emigi
emigracio	emigracio
emigrado	emigrado
emigri	emigri
eminenĉo	eminenĉo
emio	emio
emitoro	emitoro
empetro	empetro
empireo	empireo
emporio	emporio
emulsiantaĵo	emulsiantaĵo
emulsianto	emulsianto
emulsiazo	emulsiazo
emulsieblo	emulsieblo
emulsiilo	emulsiilo
emulsiino	emulsiino
emulsioido	emulsioido
enantiomorfa	enantiomorfa
enantiomorfeco	enantiomorfeco
enantiomorfismo	enantiomorfismo
enantiotropa	enantiotropa
enantiotropeco	enantiotropeco
enantiotropismo	enantiotropismo
enantiozo	enantiozo
encefalalgio	encefalalgio
encefalino	encefalino
encefalografio	encefalografio
endodermo	endodermo
endogena	endogena
endokrinologio	endokrinologio
endomorfio	endomorfio
endorfino	endorfino
endoskopio	endoskopio
endospermo	endospermo
endotelio	endotelio
engloj	engloj
enkaŭstiki	enkaŭstiki
enkaŭstiko	enkaŭstiko
enklizaĵo	enklizaĵo
enklizo	enklizo
enologo	enologo
enoteracoj	enoteracoj
ensiferoj	ensiferoj
entelekio	entelekio
entelo	entelo
enteralgio	enteralgio
entero	entero
enterokinazo	enterokinazo
enteropneŭstoj	enteropneŭstoj
entolomo	entolomo
entomoloĝo	entomoloĝo
entomostrakoj	entomostrakoj
enumeracio	enumeracio
enzimologio	enzimologio
eola	eola
eono	eono
eonotemo	eonotemo
eosto	eosto
epakrido	epakrido
epanortozo	epanortozo
epeirogenezo	epeirogenezo
epentezo	epentezo
eperlano	eperlano
epicentro	epicentro
epidendro	epidendro
epididimo	epididimo
epifenomeno	epifenomeno
epifito	epifito
epifizito	epifizito
epifonemo	epifonemo
epigeneza	epigeneza
epigenezo	epigenezo
epika	epika
epikanto	epikanto
epiko	epiko
epikondilo	epikondilo
epiloĝo	epiloĝo
epimorfio	epimorfio
epinefrino	epinefrino
epipaktido	epipaktido
epipaleolitiko	epipaleolitiko
epiploo	epiploo
epirogeneza	epirogeneza
epirogenezo	epirogenezo
episomo	episomo
epispastika	epispastika
epistakso	epistakso
epistata	epistata
epistemologio	epistemologio
epitaksio	epitaksio
epitalamo	epitalamo
epiteliomo	epiteliomo
epodo	epodo
epoksio	epoksio
epsilono	epsilono
epuliso	epuliso
erareco	erareco
eratika	eratika
eratumo	eratumo
erepsino	erepsino
eretio	eretio
eretismo	eretismo
ergativo	ergativo
ergonomio	ergonomio
ergosterolo	ergosterolo
ergotozo	ergotozo
erigerono	erigerono
erikacoj	erikacoj
erinjo	erinjo
eritemo	eritemo
eritreno	eritreno
eritroblasto	eritroblasto
eritroksilo	eritroksilo
eritronio	eritronio
eritropoezino	eritropoezino
eritropoezo	eritropoezo
eritrozo	eritrozo
erizifaloj	erizifaloj
erizifo	erizifo
erodio	erodio
erofilo	erofilo
erota	erota
erotismo	erotismo
erotizi	erotizi
eroto	eroto
erotogena	erotogena
erotologio	erotologio
erudi	erudi
esameni	esameni
esameno	esameno
esceto	esceto
eskalopo	eskalopo
eskapismo	eskapismo
eskaro	eskaro
eskatologio	eskatologio
eskimumi	eskimumi
eskulino	eskulino
eskulo	eskulo
eskvizita	eskvizita
esplanado	esplanado
espozi	espozi
espresaparato	espresaparato
espresilo	espresilo
espresmaŝino	espresmaŝino
espreso	espreso
espresomaŝino	espresomaŝino
esteco	esteco
esterazo	esterazo
estezo	estezo
estezometro	estezometro
estiel	estiel
estivacio	estivacio
estradiolo	estradiolo
etalono	etalono
etanalo	etanalo
etano	etano
etanolato	etanolato
eteno	eteno
etilismo	etilismo
etimoloĝo	etimoloĝo
etino	etino
etiola	etiola
etioloĝo	etioloĝo
etlingero	etlingero
etoksi	etoksi
etoksio	etoksio
etoŝo	etoŝo
etrioskopo	etrioskopo
etuvi	etuvi
etuvo	etuvo
etuzo	etuzo
evangelizi	evangelizi
evaporito	evaporito
evipano	evipano
evoluto	evoluto
evolvento	evolvento
evolŭi	evolŭi
ezofagoskopio	ezofagoskopio
ezofagoskopo	ezofagoskopo
ezofaĝo	ezofaĝo
ezokedoj	ezokedoj
eĥolalio	eĥolalio
eŝolzio	eŝolzio
eŭ	eŭ
eŭdajmonismo	eŭdajmonismo
eŭfaŭzio	eŭfaŭzio
eŭfaŭziuloj	eŭfaŭziuloj
eŭfonio	eŭfonio
eŭgenio	eŭgenio
eŭgleno	eŭgleno
eŭkariota	eŭkariota
eŭkarioto	eŭkarioto
eŭkariotoj	eŭkariotoj
eŭklida	eŭklida
eŭmetropa	eŭmetropa
eŭmetropeco	eŭmetropeco
eŭpepsio	eŭpepsio
eŭpneo	eŭpneo
eŭripterigio	eŭripterigio
eŭritmo	eŭritmo
eŭtekto	eŭtekto
fa	fa
facia	facia
facio	facio
faduo	faduo
fagacoj	fagacoj
faktiso	faktiso
faktoto	faktoto
fakultativa	fakultativa
fakulto	fakulto
falangeredoj	falangeredoj
falanstero	falanstero
falanĝo	falanĝo
falarido	falarido
falenopso	falenopso
falkedoj	falkedoj
faloida	faloida
falunejo	falunejo
faluni	faluni
faluno	faluno
falusa	falusa
faluseca	faluseca
faluso	faluso
falva	falva
falĉatoro	falĉatoro
fanarioto	fanarioto
fanero	fanero
fanerozoiko	fanerozoiko
fango	fango
fanono	fanono
fantasio	fantasio
fantasmo	fantasmo
fantasta	fantasta
fantasto	fantasto
faringoskopio	faringoskopio
farnezolo	farnezolo
farniento	farniento
farŝo	farŝo
fasmuloj	fasmuloj
fazanedoj	fazanedoj
fazeoluso	fazeoluso
faĉo	faĉo
faĝero	faĝero
faĝo	faĝo
faŭcio	faŭcio
faŭltlipo	faŭltlipo
faŭlto	faŭlto
faŭltspegulo	faŭltspegulo
faŭvismo	faŭvismo
feako	feako
federalismo	federalismo
feldmarŝalo	feldmarŝalo
feldspatoido	feldspatoido
feltizi	feltizi
femina	femina
femino	femino
femto	femto
fenantreno	fenantreno
fenciklidino	fenciklidino
fenestrumo	fenestrumo
fenetolo	fenetolo
fenikacoj	fenikacoj
feniko	feniko
fenikŝo	fenikŝo
fenileno	fenileno
fenilo	fenilo
fenolato	fenolato
fenotiazino	fenotiazino
feofitino	feofitino
feofitoj	feofitoj
fericiano	fericiano
ferociano	ferociano
feruta	feruta
ferutado	ferutado
feruti	feruti
festeco	festeco
fibrilacio	fibrilacio
fibrinogeno	fibrinogeno
fibroino	fibroino
fikomicetoj	fikomicetoj
fiktivo	fiktivo
fikuso	fikuso
fikŝi	fikŝi
filariozo	filariozo
fileo	fileo
filikopsidoj	filikopsidoj
filito	filito
filodendro	filodendro
filodio	filodio
filogenezo	filogenezo
filoloĝo	filoloĝo
filopodoj	filopodoj
filosemitismo	filosemitismo
filosemito	filosemito
filostomedoj	filostomedoj
filostomo	filostomo
filtrumo	filtrumo
fimozo	fimozo
fin	fin
finanĉo	finanĉo
fineso	fineso
finia	finia
finizi	finizi
finiŝi	finiŝi
finiŝo	finiŝo
fiolo	fiolo
firno	firno
fistulino	fistulino
fitino	fitino
fitiso	fitiso
fito	fito
fitoftoro	fitoftoro
fitokromo	fitokromo
fitolako	fitolako
fitolo	fitolo
fizalio	fizalio
fiziognomiko	fiziognomiko
fizioloĝo	fizioloĝo
flagelanto	flagelanto
flamengo	flamengo
flamerio	flamerio
flamino	flamino
flamumita	flamumita
flankumita	flankumita
flasko	flasko
flavino	flavino
flavono	flavono
flebotomio	flebotomio
flebotomo	flebotomo
fleksoro	fleksoro
fleo	fleo
flikumi	flikumi
fliŝo	fliŝo
flogistono	flogistono
floroglucinolo	floroglucinolo
flugipova	flugipova
fluoresceino	fluoresceino
fokedoj	fokedoj
fokusdiseco	fokusdiseco
folianto	folianto
foliklito	foliklito
folikulino	folikulino
folioto	folioto
folulo	folulo
fonduo	fonduo
fonetisto	fonetisto
fonio	fonio
fonoforo	fonoforo
fonolito	fonolito
fonometrio	fonometrio
foradendro	foradendro
foraminiferoj	foraminiferoj
formiato	formiato
formiilo	formiilo
formio	formio
foruo	foruo
fosfatemio	fosfatemio
fosfatido	fosfatido
fosfeno	fosfeno
fosfido	fosfido
fosfino	fosfino
fosfonio	fosfonio
fosfoo	fosfoo
fosforilado	fosforilado
fosforili	fosforili
fosforilo	fosforilo
fosgeno	fosgeno
fotogrametrio	fotogrametrio
foveeto	foveeto
foveo	foveo
fragario	fragario
fraksinelo	fraksinelo
frakta	frakta
frakto	frakto
frameo	frameo
franciskanismo	franciskanismo
frandzi	frandzi
franĉi	franĉi
franĉizo	franĉizo
franĝipano	franĝipano
frazeologiaĵo	frazeologiaĵo
frazeologio	frazeologio
frazumi	frazumi
frenulo	frenulo
fri	fri
fridigado	fridigado
fridigilo	fridigilo
fridunuo	fridunuo
friga	friga
friganedoj	friganedoj
frigano	frigano
frigida	frigida
frigideco	frigideco
frigo	frigo
frigorio	frigorio
frikando	frikando
fringedoj	fringedoj
friska	friska
friŝo	friŝo
frogalo	frogalo
frogo	frogo
froko	froko
frokulo	frokulo
frontala	frontala
fruktologio	fruktologio
fruktozo	fruktozo
frustracio	frustracio
ftalato	ftalato
ftaleino	ftaleino
ftalilo	ftalilo
ftalo	ftalo
ftiro	ftiro
fuelo	fuelo
fukoficoj	fukoficoj
fulereno	fulereno
fulgoro	fulgoro
fulgoromorfoj	fulgoromorfoj
fulminado	fulminado
fumarato	fumarato
fumarolo	fumarolo
fumigacio	fumigacio
fumizi	fumizi
fumumi	fumumi
fumumo	fumumo
fungicido	fungicido
fungologio	fungologio
fungozo	fungozo
fungusa	fungusa
fungusaĵo	fungusaĵo
funikularo	funikularo
funkciala	funkciala
funkcionalo	funkcionalo
funko	funko
furalo	furalo
furano	furano
furgono	furgono
furnituro	furnituro
furunkozo	furunkozo
futurologio	futurologio
fuzelo	fuzelo
fuzulinedoj	fuzulinedoj
fuŝ	fuŝ
gabro	gabro
gadedoj	gadedoj
gadmeso	gadmeso
gadoformaj	gadoformaj
gageo	gageo
galaktozo	galaktozo
galalito	galalito
galango	galango
galbi	galbi
galbo	galbo
galbuledoj	galbuledoj
galeaso	galeaso
galeco	galeco
galega	galega
galeo	galeo
galgo	galgo
galikana	galikana
galikanismo	galikanismo
galino	galino
galinoformaj	galinoformaj
galioto	galioto
galuso	galuso
galvanizado	galvanizado
gamaro	gamaro
gametofito	gametofito
gamopetaloj	gamopetaloj
gangliito	gangliito
gangujo	gangujo
gantro	gantro
garcinio	garcinio
gareno	gareno
garigo	garigo
gario	gario
gasogeno	gasogeno
gasojlo	gasojlo
gasteromicetoj	gasteromicetoj
gastralgio	gastralgio
gastrektomio	gastrektomio
gastrino	gastrino
gastrofilo	gastrofilo
gastroknemio	gastroknemio
gasumi	gasumi
gatjo	gatjo
gaviformaj	gaviformaj
gavioformaj	gavioformaj
gazalo	gazalo
gaĝo	gaĝo
geastro	geastro
gefireoj	gefireoj
gelo	gelo
gemuta	gemuta
genealoĝo	genealoĝo
geocentra	geocentra
geodinamiko	geodinamiko
geofagio	geofagio
geoido	geoido
geokemio	geokemio
geokronologio	geokronologio
geoloĝo	geoloĝo
geomancio	geomancio
geomorfologio	geomorfologio
geopolitiko	geopolitiko
georgiko	georgiko
geosfero	geosfero
geosinklinalo	geosinklinalo
geotekniko	geotekniko
geoterma	geoterma
geotermiko	geotermiko
geotermismo	geotermismo
geotermo	geotermo
geotropismo	geotropismo
geotrupedoj	geotrupedoj
geranialo	geranialo
geraniolo	geraniolo
geraĵo	geraĵo
geri	geri
geriatrio	geriatrio
geriatro	geriatro
geriso	geriso
germaniato	germaniato
germanisto	germanisto
gero	gero
gesnerio	gesnerio
ghetto	ghetto
giardio	giardio
giardiozo	giardiozo
giberelino	giberelino
gigo	gigo
gimnastikilo	gimnastikilo
gimnotedoj	gimnotedoj
ginsengo	ginsengo
gipo	gipo
gipsofilo	gipsofilo
gipuro	gipuro
gireca	gireca
giromitrino	giromitrino
gisisto	gisisto
glaciologio	glaciologio
glagolico	glagolico
glatiso	glatiso
glaŭka	glaŭka
glebo	glebo
glediĉio	glediĉio
glicero	glicero
gliko	gliko
glikogeno	glikogeno
glikogenogenezo	glikogenogenezo
glikogenolizo	glikogenolizo
glikokaliko	glikokaliko
glio	glio
glioksalo	glioksalo
gliredoj	gliredoj
gliŝi	gliŝi
globino	globino
globoskopo	globoskopo
globulestiĝo	globulestiĝo
glomerulo	glomerulo
gloriozo	gloriozo
glosektomio	glosektomio
glosolalio	glosolalio
glucido	glucido
glucinio	glucinio
gluizi	gluizi
glukagono	glukagono
gluko	gluko
glukolizo	glukolizo
glukozemio	glukozemio
glukozido	glukozido
glukozurio	glukozurio
glukurio	glukurio
glumelo	glumelo
gluono	gluono
glutaro	glutaro
glutationo	glutationo
glutenino	glutenino
gnafalio	gnafalio
gnetopsidoj	gnetopsidoj
gnidio	gnidio
gnozo	gnozo
gobelino	gobelino
gobiusedoj	gobiusedoj
gobiusoidoj	gobiusoidoj
goetito	goetito
gofero	gofero
gofri	gofri
gofrilo	gofrilo
gojo	gojo
goliardi	goliardi
goliardo	goliardo
golĝaparato	golĝaparato
golĝokorpo	golĝokorpo
gombo	gombo
gomenolarbo	gomenolarbo
gomenolo	gomenolo
gongorismo	gongorismo
gonidio	gonidio
goniometra	goniometra
goniometri	goniometri
goniometrio	goniometrio
goniometro	goniometro
gonokokemio	gonokokemio
gonokokozo	gonokokozo
gordiuloj	gordiuloj
gosipio	gosipio
gospelo	gospelo
grabeno	grabeno
gradacio	gradacio
gradualo	gradualo
grajnovora	grajnovora
gramino	gramino
grand	grand
granitoido	granitoido
granulocito	granulocito
granulomo	granulomo
granulomozo	granulomozo
graptolitoj	graptolitoj
grasumi	grasumi
grasumo	grasumo
gratiolo	gratiolo
gravetio	gravetio
gravimetrio	gravimetrio
graviolarbo	graviolarbo
graviolbero	graviolbero
graviolo	graviolo
graviolujo	graviolujo
gravitometrio	gravitometrio
gravitono	gravitono
graŭli	graŭli
graŭvako	graŭvako
gregarinoj	gregarinoj
grejhundo	grejhundo
greĝo	greĝo
griledoj	griledoj
grindelio	grindelio
grioto	grioto
grivo	grivo
grizuo	grizuo
grondi	grondi
gropo	gropo
grosulariacoj	grosulariacoj
grosulario	grosulario
groĝo	groĝo
grumela	grumela
grumelo	grumelo
grumiŝambero	grumiŝambero
grumiŝamo	grumiŝamo
grumiŝamujo	grumiŝamujo
grundologio	grundologio
guanino	guanino
guglego	guglego
guglo	guglo
gujdako	gujdako
gumozo	gumozo
guno	guno
guruo	guruo
gustosena	gustosena
gutao	gutao
gutiferoj	gutiferoj
gutujo	gutujo
guĝarato	guĝarato
guĝi	guĝi
guĝo	guĝo
gvanako	gvanako
gvarano	gvarano
gvemulo	gvemulo
gverilo	gverilo
hadeano	hadeano
hagiso	hagiso
hajduko	hajduko
halanĝo	halanĝo
haliaeto	haliaeto
halito	halito
halofito	halofito
haloido	haloido
halucinozo	halucinozo
halvao	halvao
hamadriado	hamadriado
hamiltoniano	hamiltoniano
hanapo	hanapo
handspeko	handspeko
hansa	hansa
hansano	hansano
haomo	haomo
haoro	haoro
hapakso	hapakso
hapaledoj	hapaledoj
haplografio	haplografio
haploida	haploida
hariso	hariso
harmonizi	harmonizi
harneso	harneso
harpagofito	harpagofito
haruspekso	haruspekso
haspelaĵo	haspelaĵo
haspeli	haspeli
haspelo	haspelo
hati	hati
hav	hav
haĉeko	haĉeko
haŝio	haŝio
haŭsero	haŭsero
haŭsiero	haŭsiero
haŭso	haŭso
haŭstorio	haŭstorio
hebefrenio	hebefrenio
hebeta	hebeta
hebeteco	hebeteco
hebreisto	hebreisto
hedizaro	hedizaro
hedonismo	hedonismo
hedonisto	hedonisto
heks	heks
heksa	heksa
heksano	heksano
hektika	hektika
helicoido	helicoido
helikonio	helikonio
helio	helio
heliocentra	heliocentra
heliografio	heliografio
heliogravuro	heliogravuro
helioskopo	helioskopo
helioterapio	helioterapio
heliĉo	heliĉo
helmintologio	helmintologio
helmintozo	helmintozo
helmo	helmo
helodeo	helodeo
hemanto	hemanto
hematemezo	hematemezo
hematino	hematino
hematio	hematio
hemato	hemato
hematoksilino	hematoksilino
hematoksilo	hematoksilo
hematozo	hematozo
hematozooj	hematozooj
hemi	hemi
hemianopsio	hemianopsio
hemicelulozo	hemicelulozo
hemimorfito	hemimorfito
hemiĥordo	hemiĥordo
hemiĥorduloj	hemiĥorduloj
hemo	hemo
hemolizo	hemolizo
hemoo	hemoo
hemoptizo	hemoptizo
hemostaza	hemostaza
hemostazo	hemostazo
hendiado	hendiado
henikoz	henikoz
heparino	heparino
hept	hept
hepta	hepta
heptagono	heptagono
heptano	heptano
herbicido	herbicido
herbovora	herbovora
hercinia	hercinia
herdo	herdo
hermeneŭtiko	hermeneŭtiko
hermita	hermita
herniario	herniario
heroido	heroido
herpesto	herpesto
herso	herso
hesperido	hesperido
hesperornito	hesperornito
hesperornitoformaj	hesperornitoformaj
hetero	hetero
heterogameta	heterogameta
heteronomio	heteronomio
heteropteroj	heteropteroj
heterosomo	heterosomo
heterotrofa	heterotrofa
heterozido	heterozido
heterozigoto	heterozigoto
heveo	heveo
heŭristiko	heŭristiko
hibaĉo	hibaĉo
hidalgo	hidalgo
hidatido	hidatido
hidatidozo	hidatidozo
hidno	hidno
hidranto	hidranto
hidrastido	hidrastido
hidrasto	hidrasto
hidrati	hidrati
hidratiĝi	hidratiĝi
hidrazino	hidrazino
hidrazono	hidrazono
hidridi	hidridi
hidrido	hidrido
hidrofila	hidrofila
hidrofoba	hidrofoba
hidrofono	hidrofono
hidrografio	hidrografio
hidroidoj	hidroidoj
hidrokarbonido	hidrokarbonido
hidrokarido	hidrokarido
hidrokarito	hidrokarito
hidrokero	hidrokero
hidrokotilo	hidrokotilo
hidroksilo	hidroksilo
hidroksio	hidroksio
hidrologio	hidrologio
hidronio	hidronio
hidroreo	hidroreo
hidroĥero	hidroĥero
hidruloj	hidruloj
hieroduleco	hieroduleco
hierodulo	hierodulo
hierofanto	hierofanto
hierogamio	hierogamio
hifo	hifo
hifolomo	hifolomo
higrocibo	higrocibo
higroforo	higroforo
higrografo	higrografo
higrometria	higrometria
higrometrio	higrometrio
hihi	hihi
hihii	hihii
hiki	hiki
hiksoso	hiksoso
hiledoj	hiledoj
hilozoismo	hilozoismo
himantopo	himantopo
himatio	himatio
himeneo	himeneo
himenomicetoj	himenomicetoj
hino	hino
hiogloso	hiogloso
hioido	hioido
hiosciamo	hiosciamo
hipalago	hipalago
hipeastro	hipeastro
hiper	hiper
hiperestezio	hiperestezio
hipergonaro	hipergonaro
hiperono	hiperono
hiphopo	hiphopo
hipio	hipio
hipno	hipno
hipnotizi	hipnotizi
hipnozo	hipnozo
hipo	hipo
hipofagio	hipofagio
hipofeo	hipofeo
hipofizo	hipofizo
hipogeo	hipogeo
hipogina	hipogina
hipokastanacoj	hipokastanacoj
hipokaŭsto	hipokaŭsto
hipokondro	hipokondro
hipokritado	hipokritado
hipolao	hipolao
hipospadio	hipospadio
hipostazo	hipostazo
hipotalamo	hipotalamo
hipotalo	hipotalo
hipotenaro	hipotenaro
hipsogramo	hipsogramo
hipsokroma	hipsokroma
hipuro	hipuro
hirtismo	hirtismo
hirudino	hirudino
hirundedoj	hirundedoj
hiskiamino	hiskiamino
histidino	histidino
histologio	histologio
histono	histono
historiografio	historiografio
hitita	hitita
hobalo	hobalo
hoboĵo	hoboĵo
hodometro	hodometro
hojo	hojo
holandezo	holandezo
holko	holko
holmo	holmo
holocefaloj	holocefaloj
holoedreco	holoedreco
holoedro	holoedro
holomorfa	holomorfa
holomorfio	holomorfio
holosteo	holosteo
holosteoj	holosteoj
holosto	holosto
holoturioidoj	holoturioidoj
homedoj	homedoj
homenoj	homenoj
homeomorfa	homeomorfa
homeomorfia	homeomorfia
homeomorfio	homeomorfio
homeomorfo	homeomorfo
homeostatilo	homeostatilo
homeostato	homeostato
homeota	homeota
homeoteleŭto	homeoteleŭto
homeoterma	homeoterma
homilio	homilio
homizi	homizi
homofono	homofono
homokromio	homokromio
homologio	homologio
homomorfa	homomorfa
homomorfia	homomorfia
homomorfio	homomorfio
homomorfo	homomorfo
homopteroj	homopteroj
homoseksuala	homoseksuala
homoteta	homoteta
homotetia	homotetia
homotetio	homotetio
homoteto	homoteto
homotopa	homotopa
homotopia	homotopia
homotopio	homotopio
homotopo	homotopo
homunkulo	homunkulo
hopadi	hopadi
hoplito	hoplito
horsisto	horsisto
horso	horso
horsto	horsto
horsulo	horsulo
horto	horto
hoso	hoso
hospico	hospico
hotentoto	hotentoto
hui	hui
hulmano	hulmano
humino	humino
humiĝo	humiĝo
humoresko	humoresko
humulo	humulo
huro	huro
hurono	hurono
husano	husano
huŝi	huŝi
iai	iai
iberiso	iberiso
idempotenta	idempotenta
idiopatio	idiopatio
idli	idli
idlilo	idlilo
iduso	iduso
ifrito	ifrito
iglo	iglo
ignimbrito	ignimbrito
igvanedoj	igvanedoj
ikonografia	ikonografia
ikonografio	ikonografio
ikonologio	ikonologio
ikonoskopo	ikonoskopo
ikonostazo	ikonostazo
ikoro	ikoro
ikosaedro	ikosaedro
ikoz	ikoz
iksio	iksio
iksoro	iksoro
iktiofagio	iktiofagio
iktiologio	iktiologio
iktiologo	iktiologo
iktiopterigoj	iktiopterigoj
iktiozo	iktiozo
ikto	ikto
ikŝo	ikŝo
ileito	ileito
ilekŝo	ilekŝo
iliaka	iliaka
iliako	iliako
ilio	ilio
ilmenito	ilmenito
iluminacio	iluminacio
imamujo	imamujo
imbecileco	imbecileco
imbecilo	imbecilo
imbriki	imbriki
imersio	imersio
imidazolo	imidazolo
imido	imido
imino	imino
impatiento	impatiento
imperatoreco	imperatoreco
imperatoro	imperatoro
imperfektivo	imperfektivo
impetigino	impetigino
impetigizado	impetigizado
impoŝtaro	impoŝtaro
impoŝto	impoŝto
imprimaturo	imprimaturo
impulŝo	impulŝo
imunologio	imunologio
inanicio	inanicio
incenŝo	incenŝo
incizado	incizado
incizaĵo	incizaĵo
incizi	incizi
incizo	incizo
incizuro	incizuro
indekŝo	indekŝo
indeno	indeno
indiferentismo	indiferentismo
indigoida	indigoida
indigozidazo	indigozidazo
indigozido	indigozido
indiumo	indiumo
individŭo	individŭo
indiĝo	indiĝo
indolo	indolo
indrio	indrio
indukcio	indukcio
induktoro	induktoro
indulto	indulto
induzio	induzio
inerciuma	inerciuma
infamio	infamio
infanto	infanto
infarktogena	infarktogena
inferenci	inferenci
inferenco	inferenco
infimo	infimo
infra	infra
infruktesko	infruktesko
infundiblo	infundiblo
ingiĝi	ingiĝi
ingoto	ingoto
ingredienĉo	ingredienĉo
inicialo	inicialo
injektivo	injektivo
inklinacio	inklinacio
inkubacio	inkubacio
inkubatoro	inkubatoro
inkunablo	inkunablo
inocibo	inocibo
insilado	insilado
insilaĵo	insilaĵo
insili	insili
insilujo	insilujo
insinui	insinui
insinuo	insinuo
insolenta	insolenta
instanĉo	instanĉo
instruktoro	instruktoro
instrumentalo	instrumentalo
insuficienco	insuficienco
integrato	integrato
integrebla	integrebla
integrismo	integrismo
integristo	integristo
inteligencio	inteligencio
intenŝa	intenŝa
interfazo	interfazo
interferometrio	interferometrio
interfono	interfono
interioro	interioro
interkomo	interkomo
interleŭkino	interleŭkino
interstica	interstica
interstico	interstico
intertrigo	intertrigo
interuptoro	interuptoro
intervjŭo	intervjŭo
intimismo	intimismo
intra	intra
intradoso	intradoso
intumeska	intumeska
invencio	invencio
invertazo	invertazo
involucio	involucio
inĝenierio	inĝenierio
iona	iona
ionika	ionika
iono	iono
ipeko	ipeko
ipo	ipo
ipomeo	ipomeo
iredentisto	iredentisto
irigatoro	irigatoro
irisektomio	irisektomio
irisito	irisito
irisotomio	irisotomio
iriŝo	iriŝo
irko	irko
isato	isato
iskemio	iskemio
iskiatalgio	iskiatalgio
iskiato	iskiato
ismailano	ismailano
isolepo	isolepo
iteracii	iteracii
iteracio	iteracio
itol	itol
izatiso	izatiso
izo	izo
izobato	izobato
izoelektra	izoelektra
izogloso	izogloso
izogono	izogono
izohipso	izohipso
izoklino	izoklino
izolepido	izolepido
izometra	izometra
izometria	izometria
izometrio	izometrio
izometro	izometro
izomorfia	izomorfia
izomorfio	izomorfio
izopodoj	izopodoj
izopreno	izopreno
izoprenoido	izoprenoido
izopteroj	izopteroj
izospino	izospino
izostazo	izostazo
izotona	izotona
izotoneco	izotoneco
iĥtiofagio	iĥtiofagio
iĥtiologo	iĥtiologo
iĥtiopterigoj	iĥtiopterigoj
jabiruo	jabiruo
jaborando	jaborando
jadeitito	jadeitito
jadeito	jadeito
jakvo	jakvo
jakvujo	jakvujo
jalaprezino	jalaprezino
jambino	jambino
jamboso	jamboso
jango	jango
jansenismo	jansenismo
jansenisto	jansenisto
jatagano	jatagano
jaziono	jaziono
jaŝiro	jaŝiro
jekcio	jekcio
jeremiado	jeremiado
jesaulo	jesaulo
jino	jino
jodometrio	jodometrio
jodozo	jodozo
johimbino	johimbino
johimbo	johimbo
jokto	jokto
jonio	jonio
jonosfero	jonosfero
jotismo	jotismo
joviala	joviala
judaizi	judaizi
judaro	judaro
juladi	juladi
julepo	julepo
jurto	jurto
kaciko	kaciko
kacingo	kacingo
kacujo	kacujo
kacumi	kacumi
kacuro	kacuro
kadaifo	kadaifo
kadastro	kadastro
kadavrino	kadavrino
kadenzo	kadenzo
kadenĉo	kadenĉo
kadesenco	kadesenco
kadiso	kadiso
kado	kado
kadrumo	kadrumo
kafumi	kafumi
kaguango	kaguango
kainito	kainito
kairino	kairino
kairno	kairno
kajeputo	kajeputo
kakeksio	kakeksio
kakinokbero	kakinokbero
kakinoko	kakinoko
kakografio	kakografio
kakosmio	kakosmio
kaktacoj	kaktacoj
kakuminalo	kakuminalo
kaladio	kaladio
kalamagrostido	kalamagrostido
kalaminto	kalaminto
kalamo	kalamo
kalao	kalao
kalateo	kalateo
kalazio	kalazio
kalazo	kalazo
kalaĵo	kalaĵo
kalcito	kalcito
kalefakcio	kalefakcio
kalicebo	kalicebo
kalidro	kalidro
kalipso	kalipso
kalitriko	kalitriko
kalitriksedoj	kalitriksedoj
kalitrikso	kalitrikso
kalitriso	kalitriso
kalkedonio	kalkedonio
kalkpetro	kalkpetro
kalma	kalma
kalmo	kalmo
kalmodulino	kalmodulino
kalmuko	kalmuko
kalosomo	kalosomo
kaloto	kaloto
kalozo	kalozo
kalpako	kalpako
kalumeto	kalumeto
kaluso	kaluso
kalv	kalv
kalvilo	kalvilo
kamajo	kamajo
kambiumo	kambiumo
kamecipariso	kamecipariso
kamemelo	kamemelo
kamemoro	kamemoro
kameropso	kameropso
kamikazo	kamikazo
kamizardo	kamizardo
kampadismo	kampadismo
kampanĵo	kampanĵo
kanaaro	kanaaro
kanalizacio	kanalizacio
kanango	kanango
kancerogena	kancerogena
kancerologio	kancerologio
kandido	kandido
kandidozo	kandidozo
kandizi	kandizi
kaneforo	kaneforo
kanelonoj	kanelonoj
kangurŭo	kangurŭo
kanisedoj	kanisedoj
kaniso	kaniso
kannada	kannada
kannado	kannado
kanoniero	kanoniero
kanopeo	kanopeo
kanopo	kanopo
kantianismo	kantianismo
kantiismo	kantiismo
kantileno	kantileno
kaolinito	kaolinito
kaono	kaono
kapitato	kapitato
kaponiero	kaponiero
kapotasto	kapotasto
kapsikino	kapsikino
kapuso	kapuso
kaputa	kaputa
karabedoj	karabedoj
karadriedoj	karadriedoj
karaficoj	karaficoj
karafitoj	karafitoj
karagano	karagano
karakalo	karakalo
karakalpako	karakalpako
karako	karako
karakterologio	karakterologio
karakulaĵo	karakulaĵo
karakulo	karakulo
karao	karao
karbazido	karbazido
karbazo	karbazo
karbazolo	karbazolo
karbazono	karbazono
karbeno	karbeno
karbido	karbido
karbinolo	karbinolo
karboksilo	karboksilo
karbonido	karbonido
karbonilo	karbonilo
karburatoro	karburatoro
karcino	karcino
karcinomozo	karcinomozo
kardimiopatio	kardimiopatio
kardino	kardino
kardioido	kardioido
kardiologio	kardiologio
kardiopatio	kardiopatio
kardiotomio	kardiotomio
kardjalgio	kardjalgio
kardjo	kardjo
kardjotomio	kardjotomio
karduelo	karduelo
karduo	karduo
karelo	karelo
karenco	karenco
karibuo	karibuo
karino	karino
kariokinezo	kariokinezo
kariopso	kariopso
karismo	karismo
kariso	kariso
kariteo	kariteo
karjo	karjo
karmanjolo	karmanjolo
karmelanino	karmelanino
karminativa	karminativa
karnalito	karnalito
karneolo	karneolo
karnvoruloj	karnvoruloj
karotenoidoj	karotenoidoj
karpoideoj	karpoideoj
karumo	karumo
kasiso	kasiso
kasiterito	kasiterito
kaskarilo	kaskarilo
kastaneo	kastaneo
kastoreo	kastoreo
kastrumo	kastrumo
katabolaĵo	katabolaĵo
katabolo	katabolo
katadioptriko	katadioptriko
katafora	katafora
kataforezo	kataforezo
kataforo	kataforo
kataifo	kataifo
katakrezo	katakrezo
katalekta	katalekta
kataloĝo	kataloĝo
katalpo	katalpo
kataranto	kataranto
katarto	katarto
katekolo	katekolo
katenario	katenario
katetometro	katetometro
kateĥizado	kateĥizado
kateĥizanto	kateĥizanto
kateĥizato	kateĥizato
kateĥizisto	kateĥizisto
kateĥumeno	kateĥumeno
katguto	katguto
katlejo	katlejo
katoblepo	katoblepo
katokalo	katokalo
katoptriko	katoptriko
kavaliero	kavaliero
kaviedoj	kaviedoj
kavio	kavio
kazako	kazako
kazimiro	kazimiro
kaĉigilo	kaĉigilo
kaĉuo	kaĉuo
kaĥeksia	kaĥeksia
kaĥeksio	kaĥeksio
kaĥekta	kaĥekta
kaĵo	kaĵo
kaŝ	kaŝ
kaŝuba	kaŝuba
kaŝubo	kaŝubo
kaŭkalido	kaŭkalido
kaŭlerpo	kaŭlerpo
kaŭpokso	kaŭpokso
kaŭrio	kaŭrio
kaŭsalgio	kaŭsalgio
kaŭstikizi	kaŭstikizi
kaŭteriziĝo	kaŭteriziĝo
kebraĉo	kebraĉo
kecalo	kecalo
kedivo	kedivo
kefiro	kefiro
keiro	keiro
kelaro	kelaro
kelatiganto	kelatiganto
kelatigi	kelatigi
kelatiĝi	kelatiĝi
kelato	kelato
kelicero	kelicero
keliferoj	keliferoj
kelk	kelk
keloniedoj	keloniedoj
kenomelo	kenomelo
kenotrono	kenotrono
kento	kento
keo	keo
keratino	keratino
keratito	keratito
kerato	kerato
keratozo	keratozo
kerigmo	kerigmo
keteno	keteno
ketognatoj	ketognatoj
ketogrupo	ketogrupo
ketonozo	ketonozo
keĉo	keĉo
keĉuo	keĉuo
keĝerio	keĝerio
kiasmo	kiasmo
kibici	kibici
kibico	kibico
kiblo	kiblo
kibuĉo	kibuĉo
kielo	kielo
kikaro	kikaro
kiliasmo	kiliasmo
kilopodoj	kilopodoj
kimo	kimo
kinazo	kinazo
kinestezo	kinestezo
kinezismo	kinezismo
kinezo	kinezo
kinezopatio	kinezopatio
kinhidrono	kinhidrono
kinolino	kinolino
kirala	kirala
kiraleco	kiraleco
kirmesito	kirmesito
kiro	kiro
kiromanciano	kiromanciano
kiromanciisto	kiromanciisto
kiromancio	kiromancio
kironekto	kironekto
kiropraktikisto	kiropraktikisto
kiropraktiko	kiropraktiko
kiropteroj	kiropteroj
kirurĝo	kirurĝo
kiselguro	kiselguro
kitidoj	kitidoj
kitio	kitio
kitono	kitono
kivarbusto	kivarbusto
kivujo	kivujo
kiŝo	kiŝo
kladikisto	kladikisto
kladiko	kladiko
kladodio	kladodio
kladogenezo	kladogenezo
klami	klami
klamidio	klamidio
klamido	klamido
klamidomonado	klamidomonado
klamidospermoj	klamidospermoj
klarko	klarko
klaroskuro	klaroskuro
klasta	klasta
klasto	klasto
klatro	klatro
klavario	klavario
klejstogama	klejstogama
klejstogameco	klejstogameco
klematito	klematito
klementinarbo	klementinarbo
klementinujo	klementinujo
kleomo	kleomo
klepsidro	klepsidro
klerodendro	klerodendro
kleŝo	kleŝo
klimatologio	klimatologio
klineco	klineco
klinĝo	klinĝo
klistrono	klistrono
klitocibo	klitocibo
klitorektomio	klitorektomio
klitorio	klitorio
klonano	klonano
klonaĵo	klonaĵo
klonulo	klonulo
klonuso	klonuso
kloramfenikolo	kloramfenikolo
klorato	klorato
klorelo	klorelo
kloremio	kloremio
kloridemio	kloridemio
klorito	klorito
kloroficoj	kloroficoj
klorofilazo	klorofilazo
klorofitoj	klorofitoj
kloroplasto	kloroplasto
kloropreno	kloropreno
klostridio	klostridio
klozeto	klozeto
kluziacoj	kluziacoj
kluzio	kluzio
knapo	knapo
knaŭtio	knaŭtio
knedliketo	knedliketo
knelo	knelo
knido	knido
kniduloj	kniduloj
knikado	knikado
kniki	kniki
kniko	kniko
knoto	knoto
koadjutoro	koadjutoro
koano	koano
kodekŝo	kodekŝo
kodono	kodono
koenduo	koenduo
koenzimo	koenzimo
kofeino	kofeino
kofeo	kofeo
koferdamo	koferdamo
kofero	kofero
kogna	kogna
kognado	kognado
kogni	kogni
kogno	kogno
koheno	koheno
kohobi	kohobi
kojlektomio	kojlektomio
kojlostomio	kojlostomio
kokainizo	kokainizo
kokcidio	kokcidio
kokcidiozo	kokcidiozo
koklo	koklo
kokluŝoida	kokluŝoida
kokolito	kokolito
kokolituloj	kokolituloj
kokolobo	kokolobo
koksito	koksito
koksopatio	koksopatio
kolageno	kolageno
kolatitudo	kolatitudo
koldkremo	koldkremo
koleagoga	koleagoga
kolecistito	kolecistito
koleemio	koleemio
kolektoro	kolektoro
kolektujo	kolektujo
kolelitiazo	kolelitiazo
kolemboloj	kolemboloj
kolemio	kolemio
kolenkimo	kolenkimo
koleo	koleo
koleoptilo	koleoptilo
koleorizo	koleorizo
kolesterino	kolesterino
kolibacilo	kolibacilo
kolibio	kolibio
koliklo	koliklo
kolinesterazo	kolinesterazo
kolino	kolino
kolito	kolito
kolobo	kolobo
kolobomo	kolobomo
kolormetrio	kolormetrio
kolorometrio	kolorometrio
koloŝo	koloŝo
koltro	koltro
kolumelo	kolumelo
koluro	koluro
koluteo	koluteo
kolutorio	kolutorio
komasacio	komasacio
komatogena	komatogena
kombeo	kombeo
kombinacio	kombinacio
kombinatoriko	kombinatoriko
kombineo	kombineo
kombinumo	kombinumo
kombreto	kombreto
kombuo	kombuo
komelino	komelino
komiforo	komiforo
komio	komio
komisariato	komisariato
komocii	komocii
komocio	komocio
kompaŝo	kompaŝo
kompenŝi	kompenŝi
kompleksio	kompleksio
kompletorio	kompletorio
kompresoro	kompresoro
kompromitado	kompromitado
kompromito	kompromito
kompromiŝo	kompromiŝo
kompulsa	kompulsa
kompulsi	kompulsi
kompulsio	kompulsio
kompulsopago	kompulsopago
kompunda	kompunda
komsomolano	komsomolano
komtango	komtango
komunano	komunano
komunonaj	komunonaj
konceda	konceda
koncertino	koncertino
kondilartroj	kondilartroj
kondilo	kondilo
kondilomo	kondilomo
kondrektomio	kondrektomio
kondrito	kondrito
kondro	kondro
kondromo	kondromo
kondrosteoj	kondrosteoj
kondrostomo	kondrostomo
konektivo	konektivo
konestablo	konestablo
konferenĉo	konferenĉo
konfidencio	konfidencio
konfidenĉo	konfidenĉo
konfitujo	konfitujo
konflagracio	konflagracio
konfuceismo	konfuceismo
konfuziva	konfuziva
kongeli	kongeli
kongelujo	kongelujo
kongokoloraĵoj	kongokoloraĵoj
kongoruĝo	kongoruĝo
konididona	konididona
konidio	konidio
konidioforo	konidioforo
konidiujo	konidiujo
koniino	koniino
konikoido	konikoido
konkoido	konkoido
konkologio	konkologio
konkrecio	konkrecio
konkremento	konkremento
konkurenĉo	konkurenĉo
konoido	konoido
konosamento	konosamento
konotacio	konotacio
konsentite	konsentite
konsidereco	konsidereco
konsignaĵoj	konsignaĵoj
konsigni	konsigni
konskripto	konskripto
konsolido	konsolido
konstablo	konstablo
konstantano	konstantano
konstitucianto	konstitucianto
konstitui	konstitui
konstrikti	konstrikti
konstrukcii	konstrukcii
konsubstancia	konsubstancia
konsumismo	konsumismo
kontenerizi	kontenerizi
kontinuistino	kontinuistino
kontinuisto	kontinuisto
kontinŭa	kontinŭa
kontoido	kontoido
kontra	kontra
kontrabaŝo	kontrabaŝo
kontradanco	kontradanco
kontrahi	kontrahi
kontrahiĝo	kontrahiĝo
kontraktaro	kontraktaro
kontraposto	kontraposto
kontreo	kontreo
kontribŭi	kontribŭi
kontricio	kontricio
kontumaca	kontumaca
kontumaco	kontumaco
konuklo	konuklo
konulario	konulario
konulariuloj	konulariuloj
konvaleski	konvaleski
konvalesko	konvalesko
konvekcio	konvekcio
konvekŝa	konvekŝa
konvento	konvento
konvertoro	konvertoro
konverĝeco	konverĝeco
kopaifero	kopaifero
kopaivarbo	kopaivarbo
kopaivo	kopaivo
kopaivujo	kopaivujo
kopepodoj	kopepodoj
koplo	koplo
kopreno	kopreno
kopriso	kopriso
koprofagio	koprofagio
koprolalio	koprolalio
koprolito	koprolito
kopso	kopso
kopulativo	kopulativo
koraciedoj	koraciedoj
koraklo	koraklo
korakoida	korakoida
koralino	koralino
kordeliero	kordeliero
kordialo	kordialo
koregidoro	koregidoro
koregrafio	koregrafio
koreopso	koreopso
koribanto	koribanto
koridalo	koridalo
korilo	korilo
korio	korio
korioida	korioida
korizo	korizo
kormofitoj	kormofitoj
kornedo	kornedo
koroidito	koroidito
koronariito	koronariito
koronelo	koronelo
koronilo	koronilo
korozo	korozo
korporalo	korporalo
korticio	korticio
kortikosterono	kortikosterono
kortinario	kortinario
korvedoj	korvedoj
koso	koso
kotopetro	kotopetro
kozo	kozo
koĉedoj	koĉedoj
koĉoideoj	koĉoideoj
koĉuloj	koĉuloj
koŝia	koŝia
krajto	krajto
krakso	krakso
krakto	krakto
kralo	kralo
krangono	krangono
kraniologio	kraniologio
kraterelo	kraterelo
kratono	kratono
krazo	krazo
kraŭno	kraŭno
kredenco	kredenco
krejcero	krejcero
kreko	kreko
krematorio	krematorio
krementi	krementi
kremento	kremento
kreodontoj	kreodontoj
krepiti	krepiti
krescentio	krescentio
krezolo	krezolo
kreŝo	kreŝo
kribo	kribo
krifo	krifo
krikoido	krikoido
krilo	krilo
krimologio	krimologio
krinaro	krinaro
krino	krino
krinoidoj	krinoidoj
krinozooj	krinozooj
krinumo	krinumo
krioforo	krioforo
kriolito	kriolito
kriometrio	kriometrio
krioskopio	krioskopio
kripo	kripo
kriptonimo	kriptonimo
krismo	krismo
kriso	kriso
kristaloida	kristaloida
kristaloido	kristaloido
kriticismo	kriticismo
kritmo	kritmo
krizomeledoj	krizomeledoj
krizomelo	krizomelo
krizopo	krizopo
krizoprazo	krizoprazo
krizotilo	krizotilo
krokanto	krokanto
krokedo	krokedo
kromatido	kromatido
kromatinero	kromatinero
kromatino	kromatino
kromiato	kromiato
kromiflavo	kromiflavo
kromii	kromii
kromiilo	kromiilo
kromistoj	kromistoj
kromito	kromito
kromleĥo	kromleĥo
kromofora	kromofora
kromoplasto	kromoplasto
kromosfero	kromosfero
kromotipio	kromotipio
kronaksio	kronaksio
kronostratigrafio	kronostratigrafio
krosopterigoj	krosopterigoj
krotalario	krotalario
krotonalo	krotonalo
krotono	krotono
krozoforo	krozoforo
krucifikŝo	krucifikŝo
kruoro	kruoro
krupuko	krupuko
krurumo	krurumo
ksantelasmo	ksantelasmo
ksantino	ksantino
ksantio	ksantio
ksantofilo	ksantofilo
ksantomo	ksantomo
ksantomozo	ksantomozo
ksantoproteino	ksantoproteino
ksantosomo	ksantosomo
ksenartroj	ksenartroj
ksenofobo	ksenofobo
kserodermo	kserodermo
kserofito	kserofito
kseroftalmio	kseroftalmio
ksestobio	ksestobio
ksifoido	ksifoido
ksifozuroj	ksifozuroj
ksilemo	ksilemo
ksilitolo	ksilitolo
ksilo	ksilo
ksilosteo	ksilosteo
ksilozo	ksilozo
ktenoforoj	ktenoforoj
kubebo	kubebo
kuboido	kuboido
kukui	kukui
kukumiso	kukumiso
kulano	kulano
kuliŝo	kuliŝo
kulminacio	kulminacio
kultivaro	kultivaro
kultivatoro	kultivatoro
kulverto	kulverto
kumarato	kumarato
kumarino	kumarino
kumaro	kumaro
kumeno	kumeno
kumuli	kumuli
kungfuo	kungfuo
kupeli	kupeli
kupelujo	kupelujo
kupresacoj	kupresacoj
kupreso	kupreso
kuprizi	kuprizi
kupuliferoj	kupuliferoj
kurarizo	kurarizo
kuratelo	kuratelo
kurbilo	kurbilo
kurmo	kurmo
kurmujo	kurmujo
kurumo	kurumo
kurvimetro	kurvimetro
kurŝo	kurŝo
kuso	kuso
kuspida	kuspida
kuspido	kuspido
kutiklo	kutiklo
kutino	kutino
kutireakcio	kutireakcio
kuto	kuto
kvadricepso	kvadricepso
kvadriliono	kvadriliono
kvadriremo	kvadriremo
kvadro	kvadro
kvadruplekso	kvadruplekso
kvantizanto	kvantizanto
kvarcito	kvarcito
kvarilo	kvarilo
kvarterono	kvarterono
kvasiino	kvasiino
kvaso	kvaso
kvecalo	kvecalo
kver	kver
kverkido	kverkido
kvesti	kvesti
kvestisto	kvestisto
kvesto	kvesto
kvesturo	kvesturo
kveĉo	kveĉo
kvia	kvia
kvieco	kvieco
kviki	kviki
kviko	kviko
kviniliono	kviniliono
kvintesenĉo	kvintesenĉo
kvintiliono	kvintiliono
kviviti	kviviti
kvivito	kvivito
kŝatrio	kŝatrio
kŭo	kŭo
labaro	labaro
labaĵo	labaĵo
labelo	labelo
labenzimo	labenzimo
labfermento	labfermento
labiatoj	labiatoj
labilo	labilo
labo	labo
labredoj	labredoj
labro	labro
labrusko	labrusko
lagoftalmeco	lagoftalmeco
lagoftalmo	lagoftalmo
lagostomo	lagostomo
lagranĝiano	lagranĝiano
lakario	lakario
lakearo	lakearo
lakeejo	lakeejo
lakolito	lakolito
lakrimalo	lakrimalo
laktario	laktario
laktazo	laktazo
laktono	laktono
laktukario	laktukario
lakuno	lakuno
lalai	lalai
lambado	lambado
lambdismo	lambdismo
lambdo	lambdo
lambelo	lambelo
lamblio	lamblio
lambrekino	lambrekino
lambrusko	lambrusko
lamelo	lamelo
lamentinda	lamentinda
lamno	lamno
lampetro	lampetro
lancina	lancina
lancinado	lancinado
lancini	lancini
landaŭo	landaŭo
lanti	lanti
laparo	laparo
laparoskopio	laparoskopio
lapidara	lapidara
lapiezo	lapiezo
lapilaro	lapilaro
lapilo	lapilo
lapitoj	lapitoj
lapiŝo	lapiŝo
lapsano	lapsano
lardumi	lardumi
large	large
laricio	laricio
laringologio	laringologio
laringoskopio	laringoskopio
laringotomio	laringotomio
lasanjoj	lasanjoj
latifundioj	latifundioj
latisimo	latisimo
latrono	latrono
lavandulo	lavandulo
lavsonio	lavsonio
lazarono	lazarono
laŝto	laŝto
laŭnteniso	laŭnteniso
leandro	leandro
lecideo	lecideo
lecitido	lecitido
lee	lee
legaci	legaci
legalizi	legalizi
legionelo	legionelo
legionelozo	legionelozo
legumo	legumo
leguzio	leguzio
leiŝmanio	leiŝmanio
lejŝmanio	lejŝmanio
lekanoro	lekanoro
leksikografio	leksikografio
lekto	lekto
lemniskato	lemniskato
lemnisko	lemnisko
lentibulariacoj	lentibulariacoj
lentibulario	lentibulario
lenticelo	lenticelo
lentisko	lentisko
lenŝo	lenŝo
leo	leo
leontodono	leontodono
leontopodo	leontopodo
lepado	lepado
lepidio	lepidio
lepidosaŭroj	lepidosaŭroj
lepioto	lepioto
lepisto	lepisto
leptospiro	leptospiro
leptospirozo	leptospirozo
letala	letala
levatoro	levatoro
levirato	levirato
levitacio	levitacio
leŭcino	leŭcino
leŭkanto	leŭkanto
leŭko	leŭko
leŭkocitozo	leŭkocitozo
leŭkojo	leŭkojo
leŭkomo	leŭkomo
leŭkoplasto	leŭkoplasto
leŭkopoezo	leŭkopoezo
leŭkozo	leŭkozo
liceno	liceno
licenĉo	licenĉo
lida	lida
lidaro	lidaro
lienektomio	lienektomio
lienito	lienito
lienterio	lienterio
ligazo	ligazo
ligeo	ligeo
lignino	lignino
likopersiko	likopersiko
likopodiopsidoj	likopodiopsidoj
liktoro	liktoro
likveska	likveska
likveski	likveski
lila	lila
liliopsidoj	liliopsidoj
limeo	limeo
limeujo	limeujo
limfata	limfata
limfatulo	limfatulo
limfocito	limfocito
limfoida	limfoida
limino	limino
limneo	limneo
limoneno	limoneno
limonio	limonio
limonito	limonito
limuledoj	limuledoj
linalolo	linalolo
lindulino	lindulino
lindulo	lindulo
lingamo	lingamo
linoleno	linoleno
liofilizi	liofilizi
lipazo	lipazo
lipidazo	lipidazo
lipido	lipido
lipolizo	lipolizo
lipomo	lipomo
lipotimio	lipotimio
liriodendro	liriodendro
lisamfibioj	lisamfibioj
listerio	listerio
listeriozo	listeriozo
litiazo	litiazo
litologio	litologio
litopono	litopono
litopso	litopso
litosfero	litosfero
litoskopo	litoskopo
litospermo	litospermo
litotomio	litotomio
litotricio	litotricio
litrumo	litrumo
liva	liva
livedo	livedo
livida	livida
lividaĵo	lividaĵo
livuma	livuma
lizi	lizi
lizino	lizino
liziĝi	liziĝi
lizo	lizo
lizosomo	lizosomo
lizozimo	lizozimo
liĝeo	liĝeo
liĥeno	liĥeno
lj	lj
ljamo	ljamo
lobario	lobario
lobeto	lobeto
lofiformaj	lofiformaj
lofio	lofio
lofioformaj	lofioformaj
loganbero	loganbero
loganberujo	loganberujo
loganio	loganio
lok	lok
lokalo	lokalo
lokio	lokio
lokra	lokra
lokucio	lokucio
lokustelo	lokustelo
lolherbo	lolherbo
lolio	lolio
lomo	lomo
longano	longano
longisimo	longisimo
lontana	lontana
lontano	lontano
lonĝo	lonĝo
looko	looko
loranto	loranto
lordozo	lordozo
lorio	lorio
lotuŝo	lotuŝo
loĝato	loĝato
loĥio	loĥio
luketo	luketo
luksacii	luksacii
luminalo	luminalo
lumpio	lumpio
lunato	lunato
luteino	luteino
luteo	luteo
luvi	luvi
luzitano	luzitano
macerujo	macerujo
maciso	maciso
madio	madio
madreporo	madreporo
madrigalumi	madrigalumi
maduko	maduko
madzo	madzo
madzulo	madzulo
magnetoskopo	magnetoskopo
magnetrono	magnetrono
magnolifitoj	magnolifitoj
magnoliofitoj	magnoliofitoj
magnoliopsidoj	magnoliopsidoj
magoto	magoto
mahuto	mahuto
makabra	makabra
makaono	makaono
makerio	makerio
maketo	maketo
makramo	makramo
makro	makro
makrobiotiko	makrobiotiko
makrofago	makrofago
makrolido	makrolido
maksila	maksila
maksilo	maksilo
makumbo	makumbo
malajala	malajala
malajalo	malajalo
malakostrakoj	malakostrakoj
malariologio	malariologio
malgaŝo	malgaŝo
malgrand	malgrand
maligni	maligni
malmio	malmio
malonilo	malonilo
malono	malono
malstromo	malstromo
maltusismo	maltusismo
maluso	maluso
malusoideoj	malusoideoj
malvazio	malvazio
malversacio	malversacio
mamalgio	mamalgio
mamektomio	mamektomio
mamluko	mamluko
mandolo	mandolo
mandorlo	mandorlo
manesoj	manesoj
mangifero	mangifero
mangrovo	mangrovo
manihoto	manihoto
manilkaro	manilkaro
mantro	mantro
marabutejo	marabutejo
marabuto	marabuto
maranto	maranto
marasmio	marasmio
maravedo	maravedo
marelo	marelo
marimbo	marimbo
markio	markio
marmozo	marmozo
marnopetro	marnopetro
marnoŝtono	marnoŝtono
maronito	maronito
maroto	maroto
marsko	marsko
martagono	martagono
marubio	marubio
masoristo	masoristo
masoro	masoro
mastizi	mastizi
mastoidito	mastoidito
matiolo	matiolo
matraso	matraso
matrikario	matrikario
matriĉo	matriĉo
matroso	matroso
maĝori	maĝori
meato	meato
mediacio	mediacio
medianto	medianto
mediastinito	mediastinito
mediastino	mediastino
mediato	mediato
mediologio	mediologio
medolektomio	medolektomio
medolopatio	medolopatio
medolpatio	medolpatio
megalo	megalo
megaterio	megaterio
meharisto	meharisto
meharo	meharo
mejbomito	mejbomito
mejoza	mejoza
mejozo	mejozo
mekonio	mekonio
melaleŭko	melaleŭko
melanemio	melanemio
melanismo	melanismo
melano	melano
melanomo	melanomo
melaŝo	melaŝo
melbo	melbo
meleagreno	meleagreno
meleno	meleno
melitokokozo	melitokokozo
meliŝo	meliŝo
melomaneco	melomaneco
melomanio	melomanio
melomano	melomano
meloo	meloo
menado	menado
mendela	mendela
menianto	menianto
menispermo	menispermo
menonito	menonito
menstrŭo	menstrŭo
mentano	mentano
menuvero	menuvero
menŝo	menŝo
menŭo	menŭo
merbromino	merbromino
mercerizi	mercerizi
meretrici	meretrici
meretrico	meretrico
meristemo	meristemo
merkaptano	merkaptano
merkapto	merkapto
merlanĝo	merlanĝo
merleno	merleno
mero	mero
meromorfa	meromorfa
meromorfio	meromorfio
merostomoj	merostomoj
merulio	merulio
merĝo	merĝo
mesentero	mesentero
mesoentero	mesoentero
mesoo	mesoo
metadono	metadono
metafazo	metafazo
metakarpa	metakarpa
metalepso	metalepso
metalingvo	metalingvo
metalografio	metalografio
metamereco	metamereco
metamero	metamero
metanalo	metanalo
metastazo	metastazo
metazoo	metazoo
meteno	meteno
meteorito	meteorito
meteoroido	meteoroido
metionino	metionino
metoksilo	metoksilo
metoksio	metoksio
metopo	metopo
metrio	metrio
metrito	metrito
metroksilo	metroksilo
mezanto	mezanto
mezembrianto	mezembrianto
mezenkimo	mezenkimo
mezereo	mezereo
mezocefalo	mezocefalo
mezokarpo	mezokarpo
mezomereco	mezomereco
mezomerismo	mezomerismo
mezomero	mezomero
mezozooj	mezozooj
mezumi	mezumi
meĥanisto	meĥanisto
meĥanizi	meĥanizi
meĥanografio	meĥanografio
meĥanografo	meĥanografo
meĥanoterapio	meĥanoterapio
miaĵo	miaĵo
micelo	micelo
miceto	miceto
micetologio	micetologio
micetozo	micetozo
midraŝo	midraŝo
midriaziga	midriaziga
midriazo	midriazo
midzado	midzado
midzi	midzi
midŝipmano	midŝipmano
migalo	migalo
migdalino	migdalino
migmatito	migmatito
mihrabo	mihrabo
miito	miito
mijozo	mijozo
mikobakterio	mikobakterio
mikologio	mikologio
mikologo	mikologo
mikoplasmaloj	mikoplasmaloj
mikoplasmo	mikoplasmo
mikoplasmoj	mikoplasmoj
mikorizo	mikorizo
mikrobicido	mikrobicido
mikrobologio	mikrobologio
mikrolita	mikrolita
mikrolito	mikrolito
mikropilo	mikropilo
mikroskopio	mikroskopio
mikrosporozo	mikrosporozo
mikroto	mikroto
miks	miks
miksedemo	miksedemo
miksino	miksino
miksinoformaj	miksinoformaj
miksomatozo	miksomatozo
miksomicetoj	miksomicetoj
miksomikotoj	miksomikotoj
miksta	miksta
mileego	mileego
milenarismo	milenarismo
mileniismo	mileniismo
milenio	milenio
miliara	miliara
mimulo	mimulo
minca	minca
minestrono	minestrono
minstrelo	minstrelo
minutatoro	minutatoro
minuŝ	minuŝ
mio	mio
miokardio	miokardio
miokastoro	miokastoro
miomo	miomo
miono	miono
miopatio	miopatio
mioziga	mioziga
miozino	miozino
miozo	miozo
mirabilo	mirabilo
miria	miria
miringito	miringito
miringo	miringo
miringotomio	miringotomio
mirlitono	mirlitono
mirmekofagedoj	mirmekofagedoj
mirmidono	mirmidono
mirobolano	mirobolano
miroksilo	miroksilo
mirtacoj	mirtacoj
misterio	misterio
misulo	misulo
misĥanto	misĥanto
mitokondrio	mitokondrio
mitridatizi	mitridatizi
miĉelo	miĉelo
mjelino	mjelino
mjelopatio	mjelopatio
mks	mks
mksa	mksa
mobilo	mobilo
mocarelo	mocarelo
mocio	mocio
moderatoro	moderatoro
modilono	modilono
molaedoj	molaedoj
molao	molao
molaso	molaso
molinio	molinio
molio	molio
molvo	molvo
momordiko	momordiko
monardo	monardo
monazito	monazito
monelmetalo	monelmetalo
monelo	monelo
monilio	monilio
monodelfo	monodelfo
monofizita	monofizita
monofizito	monofizito
monoftongo	monoftongo
monomorfio	monomorfio
monosoma	monosoma
monstero	monstero
monstranco	monstranco
morao	morao
mordvo	mordvo
moreloj	moreloj
morfio	morfio
morfogenezo	morfogenezo
mortadelo	mortadelo
mortalo	mortalo
morteco	morteco
mortideva	mortideva
mortinda	mortinda
morulo	morulo
morŭo	morŭo
moskatelo	moskatelo
motaciledoj	motaciledoj
moteo	moteo
moteto	moteto
moveco	moveco
mozaraba	mozaraba
mozarabo	mozarabo
mozasaŭro	mozasaŭro
mudaĵo	mudaĵo
mudeĥara	mudeĥara
mudeĥaro	mudeĥaro
mudi	mudi
mudighormono	mudighormono
mudigi	mudigi
mudo	mudo
muestri	muestri
muestro	muestro
mugeto	mugeto
mugiloidoj	mugiloidoj
mugo	mugo
mukoraloj	mukoraloj
mukoro	mukoro
mukro	mukro
muletao	muletao
multipleksoro	multipleksoro
multipleto	multipleto
mumeo	mumeo
mungidoj	mungidoj
muo	muo
murbo	murbo
murekso	murekso
murzo	murzo
musako	musako
muscikapo	muscikapo
musendo	musendo
muskardeno	muskardeno
muskardino	muskardino
muskolozo	muskolozo
muslio	muslio
muslo	muslo
mustango	mustango
musterio	musterio
mutaciinto	mutaciinto
muzido	muzido
muzikalo	muzikalo
nafteno	nafteno
naftilo	naftilo
nagario	nagario
naivisto	naivisto
najlizi	najlizi
nanduo	nanduo
naneco	naneco
nanismo	nanismo
naoso	naoso
napelo	napelo
nardostakio	nardostakio
narkoanalizo	narkoanalizo
narkolepsio	narkolepsio
narkotika	narkotika
narkotino	narkotino
nartekso	nartekso
naskipova	naskipova
nasturtio	nasturtio
natalitato	natalitato
nazuo	nazuo
naŝo	naŝo
naŭkrato	naŭkrato
naŭlo	naŭlo
naŭplio	naŭplio
naŭtika	naŭtika
naŭtiko	naŭtiko
naŭtiloidoj	naŭtiloidoj
naŭto	naŭto
nefometro	nefometro
nefoskopo	nefoskopo
nefra	nefra
nefrektomio	nefrektomio
nefridio	nefridio
nefrito	nefrito
nefro	nefro
nefrolepido	nefrolepido
nefrologio	nefrologio
nefrono	nefrono
nefropatio	nefropatio
nefrozo	nefrozo
negativismo	negativismo
negativisto	negativisto
negroida	negroida
negundo	negundo
nekroforo	nekroforo
nekroloĝo	nekroloĝo
nektario	nektario
nektona	nektona
nektonano	nektonano
nektono	nektono
nektonulo	nektonulo
nelga	nelga
nelge	nelge
nelumbo	nelumbo
nemakejlo	nemakejlo
nemathelmintoj	nemathelmintoj
nemertoj	nemertoj
nen	nen
neni	neni
nenioma	nenioma
neofrono	neofrono
neogeno	neogeno
neologo	neologo
neoplasmo	neoplasmo
neoplazio	neoplazio
neornitoj	neornitoj
neotena	neotena
neoteneco	neoteneco
neotio	neotio
nepao	nepao
nepento	nepento
nepeto	nepeto
neralo	neralo
nereido	nereido
neritika	neritika
neritiko	neritiko
nero	nero
nerolio	nerolio
nerolo	nerolo
nervizi	nervizi
nervologio	nervologio
nestorianismo	nestorianismo
nestoriano	nestoriano
nette	nette
nevajo	nevajo
neŭmo	neŭmo
neŭrito	neŭrito
neŭro	neŭro
neŭrolepta	neŭrolepta
neŭroleptaĵo	neŭroleptaĵo
neŭrolepto	neŭrolepto
neŭrologo	neŭrologo
neŭromo	neŭromo
neŭropatio	neŭropatio
neŭropato	neŭropato
neŭrosporo	neŭrosporo
neŭrotropa	neŭrotropa
neŭrulo	neŭrulo
neŭtona	neŭtona
nifologio	nifologio
nikelino	nikelino
nikromo	nikromo
niksino	niksino
niktagacoj	niktagacoj
niktago	niktago
nikteo	nikteo
niktito	niktito
niobato	niobato
niobo	niobo
nistagmo	nistagmo
nitelo	nitelo
nitreno	nitreno
nitri	nitri
nitrilo	nitrilo
nitrozo	nitrozo
nitrozoilo	nitrozoilo
nitrozomonado	nitrozomonado
nitrumo	nitrumo
nocivo	nocivo
noetiko	noetiko
nokoj	nokoj
noktŭo	noktŭo
nomarkio	nomarkio
nomeso	nomeso
nominacio	nominacio
non	non
nona	nona
nonano	nonano
nono	nono
nopalo	nopalo
nor	nor
norena	norena
norito	norito
normumi	normumi
norveĝo	norveĝo
noskapino	noskapino
nostoko	nostoko
notakanto	notakanto
notakantoformaj	notakantoformaj
notofago	notofago
nov	nov
novao	novao
novismo	novismo
noĥĉo	noĥĉo
nucifrago	nucifrago
nukleazo	nukleazo
nuklegamio	nuklegamio
nukleogamio	nukleogamio
nukleoliza	nukleoliza
nukleosomo	nukleosomo
nukleotido	nukleotido
nukleozido	nukleozido
nukulo	nukulo
nuleco	nuleco
nulejo	nulejo
numena	numena
numeno	numeno
numulitedoj	numulitedoj
numulito	numulito
numulitoj	numulitoj
nutacio	nutacio
oaristo	oaristo
ob	ob
obeluso	obeluso
obeza	obeza
obezeco	obezeco
obleco	obleco
obskuranto	obskuranto
obskurismo	obskurismo
obskuristo	obskuristo
obteni	obteni
obturatoro	obturatoro
obtuzilo	obtuzilo
obĵeti	obĵeti
oceanologio	oceanologio
ocela	ocela
ocelo	ocelo
ocitocino	ocitocino
odometro	odometro
odonatoj	odonatoj
odontoido	odontoido
oestradiolo	oestradiolo
oestriga	oestriga
oestro	oestro
oestrogeno	oestrogeno
oestrono	oestrono
ofiklejdo	ofiklejdo
ofiuro	ofiuro
ofiuroidoj	ofiuroidoj
ofrio	ofrio
oftalma	oftalma
oftalmo	oftalmo
oftalmometro	oftalmometro
oftalmoskopio	oftalmoskopio
oide	oide
ojdemio	ojdemio
ojdio	ojdio
ojstredoj	ojstredoj
okluzio	okluzio
okromo	okromo
oksazolo	oksazolo
oksidazo	oksidazo
oksimo	oksimo
oksimoro	oksimoro
oksio	oksio
oksitona	oksitona
oksiuricido	oksiuricido
oksiuro	oksiuro
oksiurozo	oksiurozo
okso	okso
oksonio	oksonio
okt	okt
okta	okta
oktaedro	oktaedro
okteto	okteto
okto	okto
oktopodo	oktopodo
okzalilo	okzalilo
olato	olato
oldovajo	oldovajo
oleino	oleino
oleosomo	oleosomo
oleumo	oleumo
olfakta	olfakta
olfakto	olfakto
oligo	oligo
oligoelemento	oligoelemento
oligoketoj	oligoketoj
oligoklazo	oligoklazo
oligopolo	oligopolo
oligoterapio	oligoterapio
oligoĥeto	oligoĥeto
olivenito	olivenito
olivinito	olivinito
olivino	olivino
ologio	ologio
omaso	omaso
omatidio	omatidio
omego	omego
omeno	omeno
omento	omento
omero	omero
ommetro	ommetro
omnibuŝo	omnibuŝo
onagracoj	onagracoj
onagro	onagro
onagroleo	onagroleo
onani	onani
oncidio	oncidio
ongleto	ongleto
onikŝo	onikŝo
onio	onio
onko	onko
onkocerko	onkocerko
onkocerkozo	onkocerkozo
onkogena	onkogena
onkologio	onkologio
onomastiko	onomastiko
ononido	ononido
onopordo	onopordo
oomikotoj	oomikotoj
oosfero	oosfero
oosporo	oosporo
opaka	opaka
operkulo	operkulo
operono	operono
opidumo	opidumo
opiliono	opiliono
opilionuloj	opilionuloj
opoterapio	opoterapio
opresi	opresi
opresio	opresio
opta	opta
optimuma	optimuma
opto	opto
optometrio	optometrio
optometro	optometro
or	or
orangutano	orangutano
orbikulo	orbikulo
oreado	oreado
oreo	oreo
organigramo	organigramo
organizacio	organizacio
orhava	orhava
orielo	orielo
orifico	orifico
oriflamo	oriflamo
orioledoj	orioledoj
orizo	orizo
orkidacoj	orkidacoj
orkidektomio	orkidektomio
orlopo	orlopo
ornitiskioj	ornitiskioj
ornitogalo	ornitogalo
ornitoloĝo	ornitoloĝo
ornitopo	ornitopo
ornitopodo	ornitopodo
orno	orno
orobanko	orobanko
orogenezo	orogenezo
orontio	orontio
ortaĵo	ortaĵo
ortikono	ortikono
ortodoksismo	ortodoksismo
ortodokŝa	ortodokŝa
ortofona	ortofona
ortofonisto	ortofonisto
ortognata	ortognata
ortogramo	ortogramo
ortoklazo	ortoklazo
ortokromatismo	ortokromatismo
ortoromba	ortoromba
oscilatorio	oscilatorio
oseto	oseto
oskuli	oskuli
osmiato	osmiato
ostalgio	ostalgio
osteino	osteino
ostektomio	ostektomio
osteomjelito	osteomjelito
osteopatio	osteopatio
ostino	ostino
ostiolo	ostiolo
ostito	ostito
ostogena	ostogena
ostomio	ostomio
ostomo	ostomo
ostopatio	ostopatio
ostotomio	ostotomio
ostrako	ostrako
ostrakodermoj	ostrakodermoj
ostrakodoj	ostrakodoj
ostrogoto	ostrogoto
ota	ota
otalgio	otalgio
otariedoj	otariedoj
ote	ote
otologio	otologio
otomio	otomio
otoskopio	otoskopio
otoskopo	otoskopo
ovariektomio	ovariektomio
ovariito	ovariito
ovocito	ovocito
ovogonio	ovogonio
ovoido	ovoido
ovotido	ovotido
ovovivonaskulo	ovovivonaskulo
ovri	ovri
ozazono	ozazono
ozido	ozido
ozo	ozo
ozokerito	ozokerito
ozonilo	ozonilo
ozonizi	ozonizi
ozonizilo	ozonizilo
paeljo	paeljo
pagelo	pagelo
paguredoj	paguredoj
pajeno	pajeno
pajro	pajro
paksilo	paksilo
paladino	paladino
palakvio	palakvio
palatino	palatino
palatito	palatito
paledizi	paledizi
palefreno	palefreno
palemono	palemono
paleo	paleo
paleodiktiopteroj	paleodiktiopteroj
paleogeno	paleogeno
paleontoloĝo	paleontoloĝo
palestro	palestro
palia	palia
palinodio	palinodio
paliumo	paliumo
palmata	palmata
palmito	palmito
palpebrito	palpebrito
paludismo	paludismo
panako	panako
pandaledoj	pandaledoj
pandalo	pandalo
pandemonio	pandemonio
panhaso	panhaso
paniklito	paniklito
pankracio	pankracio
pankratio	pankratio
pankreatektomio	pankreatektomio
pankreatito	pankreatito
panopeo	panopeo
panoplio	panoplio
panslavismo	panslavismo
pantoteno	pantoteno
pantuno	pantuno
panuso	panuso
papajino	papajino
papavacoj	papavacoj
papaverino	papaverino
papavino	papavino
papaŭo	papaŭo
papeco	papeco
papiamento	papiamento
papilo	papilo
papilomozo	papilomozo
papiloto	papiloto
papiro	papiro
papirologio	papirologio
papirologo	papirologo
papiruŝo	papiruŝo
papulo	papulo
paraboloido	paraboloido
paracentezo	paracentezo
paradoso	paradoso
parafizo	parafizo
parakoro	parakoro
paramecio	paramecio
parasimpato	parasimpato
paratakso	paratakso
paratiroido	paratiroido
paraziticido	paraziticido
parazitozo	parazitozo
parazooj	parazooj
parciala	parciala
paregorika	paregorika
parezo	parezo
parietario	parietario
parkumi	parkumi
parlamentario	parlamentario
parmelio	parmelio
paroksitona	paroksitona
paronikio	paronikio
paroniĥio	paroniĥio
parotidito	parotidito
partenociso	partenociso
partenogenezo	partenogenezo
partitiva	partitiva
paruedoj	paruedoj
paruzio	paruzio
pasato	pasato
paseredoj	paseredoj
paspartuo	paspartuo
pastiso	pastiso
pataĵo	pataĵo
paternalismo	paternalismo
pateto	pateto
patienco	patienco
patio	patio
patno	patno
patogenezo	patogenezo
patognomonia	patognomonia
patoloĝo	patoloĝo
patoŝo	patoŝo
patristiko	patristiko
patrologio	patrologio
patroneo	patroneo
pavano	pavano
paĉinia	paĉinia
paŝtismo	paŝtismo
paŭlinio	paŭlinio
paŭlovnio	paŭlovnio
pecajo	pecajo
pedagoĝo	pedagoĝo
pedalio	pedalio
pedicelo	pedicelo
pediklo	pediklo
pedikuri	pedikuri
pedikuristo	pedikuristo
pedipalpo	pedipalpo
pedologo	pedologo
pegmatito	pegmatito
pegoformaj	pegoformaj
pegoido	pegoido
pejorativa	pejorativa
pejotlo	pejotlo
pektineo	pektineo
pekto	pekto
pektoralo	pektoralo
pelaga	pelaga
pelagano	pelagano
pelagianismo	pelagianismo
pelagiismo	pelagiismo
pelago	pelago
pelagulo	pelagulo
peletierino	peletierino
pelmela	pelmela
pelvometrio	pelvometrio
pemfigo	pemfigo
pendentivo	pendentivo
peneedoj	peneedoj
peneo	peneo
peneplano	peneplano
penicilo	penicilo
penisito	penisito
peniŝo	peniŝo
pensionato	pensionato
pent	pent
pentano	pentano
pentanolo	pentanolo
pentotalo	pentotalo
penĉo	penĉo
peplo	peplo
peplomo	peplomo
peponedo	peponedo
pepono	pepono
pepsinogeno	pepsinogeno
peptidazo	peptidazo
peptido	peptido
pereiva	pereiva
perestrojko	perestrojko
perfektivo	perfektivo
perforado	perforado
perfori	perfori
pergolo	pergolo
perianto	perianto
periciklo	periciklo
peridio	peridio
peridotito	peridotito
peridoto	peridoto
perifrazo	perifrazo
perigina	perigina
periglacia	periglacia
perikardiito	perikardiito
perikopo	perikopo
periljo	periljo
peripetio	peripetio
perisoreo	perisoreo
perispermo	perispermo
perispirito	perispirito
peritecio	peritecio
perkedoj	perkedoj
perkoformaj	perkoformaj
perkolatoro	perkolatoro
perkolo	perkolo
perleĉo	perleĉo
perlito	perlito
perlono	perlono
permalojo	permalojo
permanenta	permanenta
permeablazo	permeablazo
pernicioza	pernicioza
perniso	perniso
peroksio	peroksio
peroksisomo	peroksisomo
peroneo	peroneo
personalo	personalo
perĉeo	perĉeo
pestiĉio	pestiĉio
pesujo	pesujo
petazo	petazo
petrigi	petrigi
petriĝi	petriĝi
petriĝo	petriĝo
petrografio	petrografio
petrologo	petrologo
petroselino	petroselino
pezizo	pezizo
peĉblendo	peĉblendo
peĉoŝtono	peĉoŝtono
pielo	pielo
pieridedoj	pieridedoj
pieriso	pieriso
pietisto	pietisto
pikareska	pikareska
pikloj	pikloj
piknidio	piknidio
pikolino	pikolino
pikrilo	pikrilo
pikro	pikro
piksidio	piksidio
pileo	pileo
pilokarpino	pilokarpino
pilokarpo	pilokarpo
pilora	pilora
piloro	piloro
pilozelo	pilozelo
pimpinelo	pimpinelo
pinacoj	pinacoj
pinakolo	pinakolo
pinakolono	pinakolono
pinano	pinano
pinao	pinao
pinata	pinata
pineno	pineno
pingvikulo	pingvikulo
pinikolo	pinikolo
pinjino	pinjino
pinjono	pinjono
pinktado	pinktado
pinofitoj	pinofitoj
pinopsidoj	pinopsidoj
pintumo	pintumo
pioemio	pioemio
piogena	piogena
pioo	pioo
piooreo	piooreo
pipelino	pipelino
piperacoj	piperacoj
pirakanto	pirakanto
piralo	piralo
piramidalo	piramidalo
piramidono	piramidono
pirano	pirano
pirekso	pirekso
pirenomicetoj	pirenomicetoj
piretrino	piretrino
pirgeometro	pirgeometro
piridilo	piridilo
piridino	piridino
pirido	pirido
piridoksalfosfato	piridoksalfosfato
piridoksalo	piridoksalo
piridoksino	piridoksino
piridokso	piridokso
piridoksolo	piridoksolo
piriko	piriko
pirimidino	pirimidino
pirno	pirno
pirofora	pirofora
pirokseno	pirokseno
pirolizi	pirolizi
pirolizo	pirolizo
pirometro	pirometro
pironismo	pironismo
pirulo	pirulo
piruso	piruso
pistacio	pistacio
pita	pita
pitagorismo	pitagorismo
pitango	pitango
pitiata	pitiata
pitiatismo	pitiatismo
pitiriazo	pitiriazo
pituito	pituito
pitĉo	pitĉo
pizolito	pizolito
piŝi	piŝi
piŝtolo	piŝtolo
pjelito	pjelito
pjelo	pjelo
placebo	placebo
plagalo	plagalo
plagioklazo	plagioklazo
plagiostomoj	plagiostomoj
planetario	planetario
planimetro	planimetro
planizado	planizado
planizi	planizi
plantologio	plantologio
planuloidoj	planuloidoj
planumo	planumo
plasmaferezo	plasmaferezo
plasmido	plasmido
plasmodesmo	plasmodesmo
plasmodio	plasmodio
plasmodo	plasmodo
plasmogamio	plasmogamio
plastia	plastia
plastidaro	plastidaro
plastido	plastido
plastieco	plastieco
plastio	plastio
plastizi	plastizi
plastizilo	plastizilo
platdiĉo	platdiĉo
platenato	platenato
platicerio	platicerio
platino	platino
platismo	platismo
platoneca	platoneca
platonisma	platonisma
platumo	platumo
plazio	plazio
plegio	plegio
plejnkanto	plejnkanto
plekso	plekso
plektranto	plektranto
plen	plen
plendinda	plendinda
pleokroa	pleokroa
pleokroeco	pleokroeco
pleokroismo	pleokroismo
pleziosaŭro	pleziosaŭro
pleŭroto	pleŭroto
ploceedoj	ploceedoj
ploceo	ploceo
ploido	ploido
plozivo	plozivo
plumbato	plumbato
plur	plur
plurilo	plurilo
pluteo	pluteo
pluŝ	pluŝ
pneŭmata	pneŭmata
pneŭmo	pneŭmo
pneŭmogastra	pneŭmogastra
pneŭmonektomio	pneŭmonektomio
pneŭmonito	pneŭmonito
pneŭmono	pneŭmono
pneŭmonokoniozo	pneŭmonokoniozo
pneŭmonologio	pneŭmonologio
pneŭmonopatio	pneŭmonopatio
poacoj	poacoj
pocio	pocio
podokarpo	podokarpo
podzolo	podzolo
poezino	poezino
poezo	poezo
pogostemono	pogostemono
pojkiloterma	pojkiloterma
pokso	pokso
polajro	polajro
polarografio	polarografio
polarono	polarono
polemologio	polemologio
polemonio	polemonio
polenologio	polenologio
poliedro	poliedro
polieno	polieno
poligalo	poligalo
poligonato	poligonato
polikroa	polikroa
polimorfa	polimorfa
polimorfeco	polimorfeco
polimorfismo	polimorfismo
polinuklea	polinuklea
poliplektro	poliplektro
poliploida	poliploida
poliporo	poliporo
poliptiko	poliptiko
polisindeto	polisindeto
polistiko	polistiko
politikologio	politikologio
politologio	politologio
politriko	politriko
polituri	polituri
poliĥetoj	poliĥetoj
poliŝo	poliŝo
poljo	poljo
pomacoj	pomacoj
pomelo	pomelo
pomfritoj	pomfritoj
pondi	pondi
pontederio	pontederio
ponĉo	ponĉo
porfirino	porfirino
porfirio	porfirio
porfuro	porfuro
porna	porna
pornaĵo	pornaĵo
porne	porne
pornemulo	pornemulo
porni	porni
pornisto	pornisto
pornografaĵo	pornografaĵo
pornografo	pornografo
pornulo	pornulo
portanco	portanco
porĉo	porĉo
potaro	potaro
potencato	potencato
poterno	poterno
potirono	potirono
pozidonio	pozidonio
pozolano	pozolano
praantropo	praantropo
praho	praho
prakrito	prakrito
pratikablo	pratikablo
prato	prato
pre	pre
precedento	precedento
precepto	precepto
precioza	precioza
predelo	predelo
predispozicii	predispozicii
prefacio	prefacio
prefaco	prefaco
prefiksoido	prefiksoido
pregado	pregado
pregi	pregi
preleĝi	preleĝi
premiuma	premiuma
premiumo	premiumo
premiŝo	premiŝo
prenanteso	prenanteso
prenipova	prenipova
presto	presto
presurizi	presurizi
presurizilo	presurizilo
pretericio	pretericio
pretora	pretora
pretorano	pretorano
pretoreco	pretoreco
pretorejo	pretorejo
pretoro	pretoro
preventorio	preventorio
prezervi	prezervi
prezidio	prezidio
priapismo	priapismo
prikli	prikli
primatologio	primatologio
primavero	primavero
primordio	primordio
pristo	pristo
probabliko	probabliko
procelariedoj	procelariedoj
procionedoj	procionedoj
prodaĵo	prodaĵo
prodo	prodo
prodromo	prodromo
produktoro	produktoro
profazo	profazo
profetino	profetino
projekciatoro	projekciatoro
prokariota	prokariota
prokarioto	prokarioto
prokariotoj	prokariotoj
prokavio	prokavio
prokaviuloj	prokaviuloj
proklizaĵo	proklizaĵo
proklizo	proklizo
prokloro	prokloro
proklorofitoj	proklorofitoj
prokuratoro	prokuratoro
prolaktino	prolaktino
prolamino	prolamino
prolanemio	prolanemio
prolano	prolano
prolepso	prolepso
proliferado	proliferado
proliferema	proliferema
proliferi	proliferi
prolino	prolino
promilo	promilo
prominenco	prominenco
prominenta	prominenta
promotoro	promotoro
prompta	prompta
prompteco	prompteco
prompti	prompti
prompto	prompto
promulgi	promulgi
promulgo	promulgo
pronado	pronado
pronanto	pronanto
proni	proni
prono	prono
prononĉi	prononĉi
prop	prop
propagero	propagero
propanalo	propanalo
propano	propano
proparoksitona	proparoksitona
propenaldehido	propenaldehido
propenalo	propenalo
propenato	propenato
propileo	propileo
propilo	propilo
propionlaktono	propionlaktono
propiono	propiono
propoliso	propoliso
propriocepti	propriocepti
proprioceptilo	proprioceptilo
propulsi	propulsi
propulsilo	propulsilo
proscenio	proscenio
prosektoro	prosektoro
prospektivo	prospektivo
prostaglandino	prostaglandino
prostatektomio	prostatektomio
prostatito	prostatito
prosteto	prosteto
prostezo	prostezo
prostitucio	prostitucio
prostitŭi	prostitŭi
prostracio	prostracio
protalo	protalo
protamino	protamino
protazo	protazo
proteido	proteido
proteinazo	proteinazo
proteinliza	proteinliza
proteo	proteo
proterozoiko	proterozoiko
protido	protido
proto	proto
protoptero	protoptero
prototrofa	prototrofa
proverbologio	proverbologio
provincialo	provincialo
proviruso	proviruso
prudeco	prudeco
prudulino	prudulino
prudulo	prudulo
prujnumo	prujnumo
prunuso	prunuso
prurito	prurito
psamito	psamito
pseŭdomorfa	pseŭdomorfa
pseŭdomorfismo	pseŭdomorfismo
pseŭdomorfiĝi	pseŭdomorfiĝi
pseŭdopodo	pseŭdopodo
psidio	psidio
psikedela	psikedela
psikedelismo	psikedelismo
psiledoj	psiledoj
psilo	psilo
psilofito	psilofito
psilofitopsidoj	psilofitopsidoj
psilotacoj	psilotacoj
psiloto	psiloto
psilotopsidoj	psilotopsidoj
psitakedoj	psitakedoj
psitakozo	psitakozo
psoaso	psoaso
psoko	psoko
psokopteroj	psokopteroj
psoraleno	psoraleno
psoro	psoro
ptarmiko	ptarmiko
pteranodonto	pteranodonto
pteraspidmorfoj	pteraspidmorfoj
pteraspido	pteraspido
pteraspidoformaj	pteraspidoformaj
pteridofitoj	pteridofitoj
pterigo	pterigo
pteriguloj	pteriguloj
pterobrankoj	pterobrankoj
pterokarpo	pterokarpo
pteroklo	pteroklo
pterosaŭroj	pterosaŭroj
ptialazo	ptialazo
ptialino	ptialino
ptilonorinkedoj	ptilonorinkedoj
ptilonorinko	ptilonorinko
ptozo	ptozo
pubio	pubio
pubiotomio	pubiotomio
puca	puca
pudenda	pudenda
pudendo	pudendo
pudinĝo	pudinĝo
pudlado	pudlado
pudli	pudli
pudo	pudo
puduo	puduo
puerpera	puerpera
puerpereco	puerpereco
pufino	pufino
pukcinio	pukcinio
pulardo	pulardo
pulko	pulko
pulkvo	pulkvo
pullo	pullo
pulmito	pulmito
pulmonario	pulmonario
pulpito	pulpito
pulsatilo	pulsatilo
pultacea	pultacea
pululi	pululi
pulŝo	pulŝo
pumilio	pumilio
pumperniklo	pumperniklo
puniko	puniko
punkturo	punkturo
puntiliema	puntiliema
puntilio	puntilio
puntistino	puntistino
pureigi	pureigi
pureigilo	pureigilo
purino	purino
purpurao	purpurao
pusado	pusado
pustulozo	pustulozo
putrino	putrino
puvaterapio	puvaterapio
puĉisto	puĉisto
puŝtua	puŝtua
pŝento	pŝento
que	que
rabdismo	rabdismo
rabdisto	rabdisto
rabdo	rabdo
rabdomancio	rabdomancio
rabetrabotilo	rabetrabotilo
rablo	rablo
rabotatoro	rabotatoro
racema	racema
racemaĵo	racemaĵo
racemigo	racemigo
radar	radar
radiacio	radiacio
radikla	radikla
radiklito	radiklito
radiklo	radiklo
radiolarioj	radiolarioj
radiolarito	radiolarito
rafanistro	rafanistro
rafeo	rafeo
rafinozo	rafinozo
raflezio	raflezio
ragtimo	ragtimo
rajoformaj	rajoformaj
rakia	rakia
rakialgio	rakialgio
rakio	rakio
rakitogena	rakitogena
rakledo	rakledo
raledoj	raledoj
ramapiteko	ramapiteko
rambutano	rambutano
ramforinko	ramforinko
ramio	ramio
ramonĉo	ramonĉo
ramplo	ramplo
ramuro	ramuro
ranĉo	ranĉo
ranĝi	ranĝi
rasli	rasli
raslo	raslo
rastro	rastro
rastrumero	rastrumero
rastrumi	rastrumi
rastrumo	rastrumo
ratio	ratio
ravenalo	ravenalo
ravioloj	ravioloj
razii	razii
razio	razio
raĝino	raĝino
raĵo	raĵo
raŝo	raŝo
raŭfo	raŭfo
raŭto	raŭto
raŭvolfio	raŭvolfio
reado	reado
realgaro	realgaro
reaŭmura	reaŭmura
rebo	rebo
rebuŝo	rebuŝo
receptaklo	receptaklo
recesio	recesio
recesiva	recesiva
receso	receso
recidivi	recidivi
recidivo	recidivo
recidivulo	recidivulo
redempti	redempti
redoksa	redoksa
redokso	redokso
redunda	redunda
redundo	redundo
reela	reela
reelo	reelo
referendario	referendario
referenĉo	referenĉo
refraktara	refraktara
refrakteco	refrakteco
refraktoro	refraktoro
regatto	regatto
regeo	regeo
regolito	regolito
regurgiti	regurgiti
regurgito	regurgito
rehabiliti	rehabiliti
rekognoski	rekognoski
rekrutisto	rekrutisto
rektumito	rektumito
rekuperi	rekuperi
rekursio	rekursio
rekvizitoro	rekvizitoro
relegacio	relegacio
reliŝo	reliŝo
remburso	remburso
remita	remita
remito	remito
remonstranto	remonstranto
remoro	remoro
remtero	remtero
ren	ren
renaĵo	renaĵo
rendevŭo	rendevŭo
reniato	reniato
renino	renino
renonci	renonci
rentabilitato	rentabilitato
reobazo	reobazo
repetitoro	repetitoro
repo	repo
reprezentiveco	reprezentiveco
reprografi	reprografi
reskripto	reskripto
resolucio	resolucio
responsorio	responsorio
restitui	restitui
restrikta	restrikta
restrikto	restrikto
retablo	retablo
retikula	retikula
retikulo	retikulo
retikulozo	retikulozo
retinaklo	retinaklo
retinalo	retinalo
retinito	retinito
retinolo	retinolo
retinoloido	retinoloido
retinopatio	retinopatio
reumo	reumo
revanĉo	revanĉo
reverendo	reverendo
reversio	reversio
revulsio	revulsio
revŭo	revŭo
rezerpino	rezerpino
rezidentejo	rezidentejo
rezidento	rezidento
reziduo	reziduo
rezistivo	rezistivo
rezoluta	rezoluta
rezorcinolo	rezorcinolo
reŭmato	reŭmato
reŭmatoida	reŭmatoida
reŭmatologio	reŭmatologio
reŭmatologo	reŭmatologo
ribeko	ribeko
ribosoma	ribosoma
ribosomo	ribosomo
ribozo	ribozo
ricevujo	ricevujo
ricinino	ricinino
rifto	rifto
rikecialoj	rikecialoj
rikeciozoj	rikeciozoj
rikura	rikura
rikuri	rikuri
rikuro	rikuro
rilaksa	rilaksa
rilaksado	rilaksado
rilaksi	rilaksi
rilegi	rilegi
ringizi	ringizi
ringumi	ringumi
rinito	rinito
rinkocefaloj	rinkocefaloj
rino	rino
rinoceredoj	rinoceredoj
rinologio	rinologio
rinoplastio	rinoplastio
rinoskopio	rinoskopio
rinĥocefaloj	rinĥocefaloj
riolito	riolito
ripidistoj	ripidistoj
riporti	riporti
riportisto	riportisto
riposti	riposti
rislingo	rislingo
ritmenbluso	ritmenbluso
ritornelo	ritornelo
rivalto	rivalto
rivolŭo	rivolŭo
rivulario	rivulario
rizobio	rizobio
rizoforejo	rizoforejo
rizoforo	rizoforo
rizokarpo	rizokarpo
rizopodoj	rizopodoj
rizorio	rizorio
robaio	robaio
robajo	robajo
robbo	robbo
robro	robro
roburo	roburo
rocelo	rocelo
rodeo	rodeo
rodofitoj	rodofitoj
rodopsino	rodopsino
roeoj	roeoj
rojadi	rojadi
rokuarbo	rokuarbo
rokuo	rokuo
romanda	romanda
romando	romando
romantismo	romantismo
romboedra	romboedra
romboedro	romboedro
rondaŭo	rondaŭo
roo	roo
rorkvalo	rorkvalo
rosometro	rosometro
rosumo	rosumo
rotaismo	rotaismo
rotao	rotao
rotenono	rotenono
roverso	roverso
ruado	ruado
ruana	ruana
rubetro	rubetro
rubuŝo	rubuŝo
rudbekio	rudbekio
rugini	rugini
rugino	rugino
rumeno	rumeno
rumoro	rumoro
runcinata	runcinata
rundo	rundo
rungo	rungo
rusigi	rusigi
rusismo	rusismo
rusko	rusko
rusulo	rusulo
rutelo	rutelo
rutena	rutena
ruteniato	ruteniato
rutilo	rutilo
rutozido	rutozido
ruĝumi	ruĝumi
ruĵo	ruĵo
sabena	sabena
sabino	sabino
sablopetro	sablopetro
saburo	saburo
sadhuo	sadhuo
safena	safena
sagŭo	sagŭo
sahibo	sahibo
sajmirio	sajmirio
sakarato	sakarato
sakarazo	sakarazo
sakarido	sakarido
sakarometrio	sakarometrio
sakaromiceto	sakaromiceto
sakrala	sakrala
salamandredoj	salamandredoj
salangano	salangano
salicino	salicino
salikato	salikato
salikilato	salikilato
salikino	salikino
salikornio	salikornio
salikozido	salikozido
salmiso	salmiso
salmonelozo	salmonelozo
salpingito	salpingito
salpo	salpo
salpuloj	salpuloj
sambo	sambo
samizdato	samizdato
samolo	samolo
sampli	sampli
samplilo	samplilo
samplo	samplo
sandarako	sandarako
sandovo	sandovo
sangrio	sangrio
sangvisorbo	sangvisorbo
saniklo	saniklo
sanpaŭlio	sanpaŭlio
sanseviero	sanseviero
santalolo	santalolo
sapeko	sapeko
sapfa	sapfa
sapfismo	sapfismo
sapfismulino	sapfismulino
saponino	saponino
sapotacoj	sapotacoj
sapotbero	sapotbero
sapreja	sapreja
sapro	sapro
sapropelo	sapropelo
saproviveco	saproviveco
saprovivulismo	saprovivulismo
saprovivulo	saprovivulo
saprozoo	saprozoo
saracenio	saracenio
sarafano	sarafano
sarako	sarako
sarcino	sarcino
sardano	sardano
sardona	sardona
sarkofaĝo	sarkofaĝo
sarkomozo	sarkomozo
sarkopsilo	sarkopsilo
sarkopto	sarkopto
sarmenta	sarmenta
sarmento	sarmento
sartorio	sartorio
sarusofono	sarusofono
satisfakcio	satisfakcio
savarino	savarino
saŝimo	saŝimo
saŭriskioj	saŭriskioj
sbiro	sbiro
scifozooj	scifozooj
scilo	scilo
scinkedoj	scinkedoj
scinko	scinko
scintili	scintili
scintilografio	scintilografio
scintilogramo	scintilogramo
scintilometro	scintilometro
scintiloskanilo	scintiloskanilo
sciuredoj	sciuredoj
sebaco	sebaco
sebasto	sebasto
sebuma	sebuma
sedeco	sedeco
sedi	sedi
sedimentologio	sedimentologio
sedo	sedo
segregacio	segregacio
seisma	seisma
seismo	seismo
seismografo	seismografo
seismogramo	seismogramo
seismologio	seismologio
seismologo	seismologo
sekio	sekio
sekreciino	sekreciino
seksologio	seksologio
sekvenci	sekvenci
sekvenco	sekvenco
sekvojadendro	sekvojadendro
selaginelo	selaginelo
selenato	selenato
selenido	selenido
selenito	selenito
selino	selino
semekarpo	semekarpo
semiologia	semiologia
semiologio	semiologio
semolo	semolo
seneskalo	seneskalo
senjoreco	senjoreco
senjorio	senjorio
senjoro	senjoro
sensitivo	sensitivo
sensiveco	sensiveco
sensometrio	sensometrio
sensora	sensora
sensorio	sensorio
sentivigi	sentivigi
sentiviĝi	sentiviĝi
senŝo	senŝo
separatismo	separatismo
separatisto	separatisto
separismo	separismo
sepiolito	sepiolito
sepsaĵo	sepsaĵo
sepseco	sepseco
sepsemio	sepsemio
serako	serako
seranedoj	seranedoj
serano	serano
serasalmo	serasalmo
serato	serato
seratulo	seratulo
sericino	sericino
sericito	sericito
serifo	serifo
serino	serino
serologio	serologio
seronegativa	seronegativa
seropozitiva	seropozitiva
serozaĵo	serozaĵo
serozo	serozo
serpentenpetro	serpentenpetro
serpentologio	serpentologio
serpigina	serpigina
serumologio	serumologio
servitudo	servitudo
sesdeknaŭumi	sesdeknaŭumi
sesila	sesila
seskvi	seskvi
seslerio	seslerio
sesterco	sesterco
sesteto	sesteto
setli	setli
setonforma	setonforma
setono	setono
sevo	sevo
sevruĝo	sevruĝo
sezamoido	sezamoido
sezelo	sezelo
sfacelo	sfacelo
sfalerito	sfalerito
sfego	sfego
sferoido	sferoido
sfigmo	sfigmo
sfigmografio	sfigmografio
sfigmografo	sfigmografo
sfingedoj	sfingedoj
sfinglipido	sfinglipido
sfingolo	sfingolo
sfingozino	sfingozino
sfinkŝo	sfinkŝo
sialo	sialo
sialogena	sialogena
sialoreo	sialoreo
siderito	siderito
sienito	sienito
sifiliŝo	sifiliŝo
sigilario	sigilario
sigmoido	sigmoido
signaturi	signaturi
signaturo	signaturo
signifika	signifika
signifikanca	signifikanca
signifikanco	signifikanco
signifiki	signifiki
silano	silano
sileo	sileo
silibo	silibo
siliciato	siliciato
siliciido	siliciido
silicozo	silicozo
silikato	silikato
silto	silto
siltopetro	siltopetro
silviedoj	silviedoj
silvino	silvino
simarubacoj	simarubacoj
simarubo	simarubo
simbionto	simbionto
simbiozanto	simbiozanto
simbranko	simbranko
simbrankoformaj	simbrankoformaj
simfalango	simfalango
simieska	simieska
simo	simo
simpata	simpata
simpatektomio	simpatektomio
simpatino	simpatino
simpato	simpato
simplekso	simplekso
simptomologio	simptomologio
simulio	simulio
simuno	simuno
sinagoĝo	sinagoĝo
sinalefo	sinalefo
sinantropo	sinantropo
sinartro	sinartro
sincitio	sincitio
sinekdoko	sinekdoko
sinerezo	sinerezo
sinistra	sinistra
sinistro	sinistro
sinistrozo	sinistrozo
sinjorido	sinjorido
sinklinalo	sinklinalo
sinkronoskopo	sinkronoskopo
sinoplo	sinoplo
sinosto	sinosto
sinoviito	sinoviito
sintagmo	sintagmo
sintakŝo	sintakŝo
sintezazo	sintezazo
sintri	sintri
sirinkso	sirinkso
sisopo	sisopo
sitŭo	sitŭo
siumo	siumo
sizaro	sizaro
sizimbrio	sizimbrio
siĥo	siĥo
skabo	skabo
skafoido	skafoido
skafopodoj	skafopodoj
skaldo	skaldo
skandiko	skandiko
skanografio	skanografio
skanografo	skanografo
skao	skao
skapo	skapo
skarifikatoro	skarifikatoro
skerĉo	skerĉo
skino	skino
skiro	skiro
skistosomo	skistosomo
skistosomozo	skistosomozo
skita	skita
skizeco	skizeco
skizofitoj	skizofitoj
skizomicetoj	skizomicetoj
skleranto	skleranto
sklerenkimo	sklerenkimo
sklerotito	sklerotito
skolekso	skolekso
skolimo	skolimo
skolio	skolio
skoliozo	skoliozo
skoliulo	skoliulo
skolopedoj	skolopedoj
skombroidoj	skombroidoj
skono	skono
skopo	skopo
skopofilio	skopofilio
skopolamino	skopolamino
skorpeno	skorpeno
skorpenoformaj	skorpenoformaj
skorpiuro	skorpiuro
skrapatoro	skrapatoro
skrofulario	skrofulario
skrutinii	skrutinii
skrutinio	skrutinio
skulptura	skulptura
skulpturo	skulpturo
skunko	skunko
skutelario	skutelario
skuti	skuti
skutilo	skutilo
skvaleno	skvaleno
skvaro	skvaro
skvaŝo	skvaŝo
slavisto	slavisto
slivovico	slivovico
slugio	slugio
slumiĝi	slumiĝi
slumo	slumo
slupo	slupo
smalto	smalto
smiconito	smiconito
smilodonto	smilodonto
snajpero	snajpero
snejlo	snejlo
sob	sob
sobiri	sobiri
sobiĝi	sobiĝi
sodokuo	sodokuo
sofito	sofito
soforo	soforo
sofrologio	sofrologio
sofrologo	sofrologo
sojplantidoj	sojplantidoj
soldanelo	soldanelo
solfataro	solfataro
solitono	solitono
solivo	solivo
soloo	soloo
solvantumi	solvantumi
somata	somata
somato	somato
somatogamio	somatogamio
somnolemo	somnolemo
somnoli	somnoli
somnolo	somnolo
somo	somo
sonko	sonko
soporo	soporo
sor	sor
soraba	soraba
sorabo	sorabo
sorado	sorado
sorbeco	sorbeco
sorbuso	sorbuso
sorikedoj	sorikedoj
soriri	soriri
sorito	sorito
soro	soro
sorpujo	sorpujo
sorĝo	sorĝo
sovĥozo	sovĥozo
spaciala	spaciala
spagato	spagato
spahio	spahio
spaliero	spaliero
sparedoj	sparedoj
sparganio	sparganio
spartio	spartio
spatango	spatango
spatulo	spatulo
spekulario	spekulario
speleo	speleo
spergulario	spergulario
spergulo	spergulo
spermatido	spermatido
spermatio	spermatio
spermatiujo	spermatiujo
spermatocito	spermatocito
spermatofitoj	spermatofitoj
spermatogenezo	spermatogenezo
spermatogonio	spermatogonio
spermicido	spermicido
spermidino	spermidino
spermino	spermino
spermogonio	spermogonio
spermoreo	spermoreo
spinako	spinako
spinelo	spinelo
spiranteso	spiranteso
spirilozo	spirilozo
spiroketaloj	spiroketaloj
spiroketozo	spiroketozo
spirometrio	spirometrio
splankniko	splankniko
splanknologio	splanknologio
splenda	splenda
splendi	splendi
splenio	splenio
spondilito	spondilito
spondilozo	spondilozo
sponta	sponta
spontaneismo	spontaneismo
spontono	spontono
sporofito	sporofito
sporogonio	sporogonio
sporotrikozo	sporotrikozo
sporotrikumo	sporotrikumo
sporozooj	sporozooj
spoto	spoto
spraji	spraji
spurti	spurti
spurto	spurto
stafilokokozo	stafilokokozo
stafilomo	stafilomo
stakio	stakio
stakiozo	stakiozo
stakiso	stakiso
stampedo	stampedo
stapelio	stapelio
statino	statino
statŭo	statŭo
stavo	stavo
stazo	stazo
staĝi	staĝi
staĥanovismo	staĥanovismo
stearo	stearo
steatito	steatito
steato	steato
steatolizo	steatolizo
steatopuga	steatopuga
steatoreo	steatoreo
steatozo	steatozo
stegi	stegi
stego	stego
stegocefaloj	stegocefaloj
stegosaŭro	stegosaŭro
stekiometria	stekiometria
stekiometrio	stekiometrio
stelario	stelario
steliono	steliono
stelita	stelita
stenografistino	stenografistino
stenografisto	stenografisto
stenomaŝino	stenomaŝino
stenozo	stenozo
steradiano	steradiano
stereo	stereo
stereoplanigrafo	stereoplanigrafo
stereotomio	stereotomio
sterido	sterido
sterilizado	sterilizado
sterilizatoro	sterilizatoro
sterilizilo	sterilizilo
sterkorario	sterkorario
sterkulio	sterkulio
sternorinkoj	sternorinkoj
stero	stero
steroido	steroido
stetoskopio	stetoskopio
stigmatizi	stigmatizi
stilito	stilito
stilobato	stilobato
stimanto	stimanto
stimi	stimi
stimo	stimo
stimulino	stimulino
stinka	stinka
stinki	stinki
stipingo	stipingo
stipito	stipito
stiĥometrio	stiĥometrio
stokasta	stokasta
stokastiko	stokastiko
stokasto	stokasto
stomatito	stomatito
stomato	stomato
stomatologio	stomatologio
stomatologo	stomatologo
stomatoskopio	stomatoskopio
stomatoskopo	stomatoskopo
stomo	stomo
stopi	stopi
storako	storako
stornelo	stornelo
stotinko	stotinko
strabotomio	strabotomio
stramonio	stramonio
strangurio	strangurio
stratigrafo	stratigrafo
stratioto	stratioto
strekumi	strekumi
strelicio	strelicio
strepsipteroj	strepsipteroj
streptokokozo	streptokokozo
streptomiceto	streptomiceto
streptopelio	streptopelio
stresa	stresa
stresi	stresi
stresigi	stresigi
stresiĝi	stresiĝi
streso	streso
streĉeco	streĉeco
strida	strida
stridi	stridi
strigedoj	strigedoj
strikno	strikno
strobo	strobo
stroboskopio	stroboskopio
strofanto	strofanto
strofario	strofario
stromatolito	stromatolito
stromo	stromo
stroncianito	stroncianito
strongilo	strongilo
strongiluloj	strongiluloj
strudelo	strudelo
stupro	stupro
sturnedoj	sturnedoj
subdukcio	subdukcio
suberino	suberino
suberito	suberito
subero	subero
suberozo	suberozo
subliminala	subliminala
subsidenco	subsidenco
substanĉo	substanĉo
subtraĥi	subtraĥi
suedo	suedo
suedoj	suedoj
sufrageto	sufrageto
sufuzi	sufuzi
sufuzo	sufuzo
suicido	suicido
suito	suito
sukcenato	sukcenato
sukcesio	sukcesio
sukerato	sukerato
sukulenta	sukulenta
sukurado	sukurado
sukurejo	sukurejo
sukuri	sukuri
sukurismo	sukurismo
sukuristo	sukuristo
sulfatamido	sulfatamido
sulfatanhidrido	sulfatanhidrido
sulfcianato	sulfcianato
sulfimido	sulfimido
sulfinato	sulfinato
sulfinilo	sulfinilo
sulfino	sulfino
sulfitanhidrido	sulfitanhidrido
sulfo	sulfo
sulfonamido	sulfonamido
sulfonato	sulfonato
sulfonilo	sulfonilo
sulfonio	sulfonio
sulfono	sulfono
sulfurilo	sulfurilo
sulkio	sulkio
sumilo	sumilo
suo	suo
suomo	suomo
supei	supei
supeo	supeo
superba	superba
supermarkto	supermarkto
supernovao	supernovao
supinanto	supinanto
suprematismo	suprematismo
surealistoj	surealistoj
surmuleto	surmuleto
suspendi	suspendi
suspendo	suspendo
suspensiero	suspensiero
suspensiigi	suspensiigi
suspensio	suspensio
suspensioido	suspensioido
suspensoria	suspensoria
suspensorio	suspensorio
suzereno	suzereno
svetero	svetero
svitenio	svitenio
tabakozo	tabakozo
tabanedoj	tabanedoj
tabeta	tabeta
tabeto	tabeto
tabetulo	tabetulo
tabuleo	tabuleo
taelo	taelo
tajgo	tajgo
tajpeca	tajpeca
takeometrio	takeometrio
takeometro	takeometro
takigrafo	takigrafo
takikardio	takikardio
takipneo	takipneo
taksiso	taksiso
taksodio	taksodio
taksono	taksono
taksuŝo	taksuŝo
talamo	talamo
talfitoj	talfitoj
taliktro	taliktro
talitro	talitro
talofitoj	talofitoj
talpedoj	talpedoj
talvego	talvego
tamaziĥto	tamaziĥto
tamburumo	tamburumo
tamo	tamo
tamponado	tamponado
tamponi	tamponi
tampono	tampono
tamula	tamula
tanacido	tanacido
tangaro	tangaro
tantalato	tantalato
tapiserio	tapiserio
tapsio	tapsio
tapso	tapso
taraksako	taraksako
tari	tari
tarsalgio	tarsalgio
tarza	tarza
tarzito	tarzito
tarzo	tarzo
tatara	tatara
tatŭi	tatŭi
tazeto	tazeto
taĉo	taĉo
taĝeto	taĝeto
taŭono	taŭono
taŭtomereco	taŭtomereco
taŭtomerismo	taŭtomerismo
taŭtomero	taŭtomero
teacoj	teacoj
tebaa	tebaa
tebaino	tebaino
tebaismo	tebaismo
tedeumo	tedeumo
tefigramo	tefigramo
teflono	teflono
tegenario	tegenario
teino	teino
tekilo	tekilo
teknikologio	teknikologio
teknikoloro	teknikoloro
teknokratio	teknokratio
teknokrato	teknokrato
teknopatio	teknopatio
telefonio	telefonio
telekinezo	telekinezo
teleksi	teleksi
telekso	telekso
telencefalo	telencefalo
teleosteoj	teleosteoj
teleŭtosporo	teleŭtosporo
telimicetoj	telimicetoj
telio	telio
teliomicetoj	teliomicetoj
telisporo	telisporo
telkele	telkele
telo	telo
telofazo	telofazo
telopeo	telopeo
teluguo	teluguo
telurito	telurito
tempumi	tempumi
tempumilo	tempumilo
tenaro	tenaro
tendenito	tendenito
tendenotomio	tendenotomio
tendenĉo	tendenĉo
tenebrio	tenebrio
tenesmo	tenesmo
teniicido	teniicido
teniozo	teniozo
teniŝo	teniŝo
tensimetrio	tensimetrio
tenujo	tenujo
tenurano	tenurano
tenuro	tenuro
teobromino	teobromino
teobromo	teobromo
teofilino	teofilino
teogonio	teogonio
teoloĝo	teoloĝo
teorbo	teorbo
tepalo	tepalo
terafozedoj	terafozedoj
terafozo	terafozo
terapeŭto	terapeŭto
terario	terario
terato	terato
teratogena	teratogena
tercino	tercino
terebintino	terebintino
tergalo	tergalo
teriako	teriako
terido	terido
terioj	terioj
terminatoro	terminatoro
termio	termio
termistoro	termistoro
termogena	termogena
ternara	ternara
teromorfoj	teromorfoj
terpeno	terpeno
terpineolo	terpineolo
terpino	terpino
testacelo	testacelo
testikito	testikito
tetanio	tetanio
tetanoso	tetanoso
tetr	tetr
tetragona	tetragona
tetraleno	tetraleno
tetraonedoj	tetraonedoj
tetrarkio	tetrarkio
tetrilo	tetrilo
teŭgo	teŭgo
teŭkrio	teŭkrio
ti	ti
tiala	tiala
tiazolo	tiazolo
tiaĵo	tiaĵo
tibuŝeno	tibuŝeno
tifeo	tifeo
tifoida	tifoida
tiglo	tiglo
tiksotropa	tiksotropa
tiksotropeco	tiksotropeco
tilandsio	tilandsio
tilburo	tilburo
tili	tili
tilito	tilito
tilo	tilo
timeleo	timeleo
timianolo	timianolo
timino	timino
timpanono	timpanono
tineedoj	tineedoj
tinio	tinio
tinno	tinno
tiofeno	tiofeno
tiolo	tiolo
tionilo	tionilo
tiono	tiono
tipologio	tipologio
tiptologio	tiptologio
tipuano	tipuano
tipuledoj	tipuledoj
tiranio	tiranio
tiratrono	tiratrono
tireo	tireo
tireoido	tireoido
tireotomio	tireotomio
tiristrono	tiristrono
tirogenea	tirogenea
tiroidektomio	tiroidektomio
tiroidito	tiroidito
tiroidstimulino	tiroidstimulino
tiroksino	tiroksino
tiroo	tiroo
tirozino	tirozino
tirso	tirso
titanato	titanato
titio	titio
titulara	titulara
tizanopteroj	tizanopteroj
tizanuroj	tizanuroj
tiĝo	tiĝo
tjurka	tjurka
tlaspo	tlaspo
tmezo	tmezo
tohuvabohuo	tohuvabohuo
tokelo	tokelo
tokoferolo	tokoferolo
tokonomo	tokonomo
toluidino	toluidino
toluilo	toluilo
toluolo	toluolo
tomano	tomano
tomio	tomio
tomografio	tomografio
tomografo	tomografo
tonidona	tonidona
toniiga	toniiga
toniigo	toniigo
tonio	tonio
tonko	tonko
tonsilektomio	tonsilektomio
topikigi	topikigi
topiko	topiko
topologo	topologo
toponimio	toponimio
tordeco	tordeco
toreado	toreado
torei	torei
toreisto	toreisto
torinoko	torinoko
tormentilo	tormentilo
tortikolo	tortikolo
tortrikedoj	tortrikedoj
tortriko	tortriko
torŝo	torŝo
toskana	toskana
totalizatoro	totalizatoro
toĝo	toĝo
toĥaro	toĥaro
trabeklo	trabeklo
trabumita	trabumita
traceado	traceado
tracei	tracei
traceo	traceo
tradeskantio	tradeskantio
tradi	tradi
trago	trago
tragoledoj	tragoledoj
tragopogo	tragopogo
tragopogono	tragopogono
trakcio	trakcio
trakelio	trakelio
trakeofitoj	trakeofitoj
trakeoido	trakeoido
trakino	trakino
trakito	trakito
trakomo	trakomo
tramelo	tramelo
tramontano	tramontano
tramvoĵo	tramvoĵo
transaĵo	transaĵo
transduktoro	transduktoro
transgreso	transgreso
transpirado	transpirado
transpiri	transpiri
transpiro	transpiro
travertino	travertino
traĥino	traĥino
traĥito	traĥito
traŭmatizi	traŭmatizi
traŭmatologio	traŭmatologio
trea	trea
tremelo	tremelo
tremolito	tremolito
treo	treo
treonino	treonino
trepidi	trepidi
treponemicido	treponemicido
treponemo	treponemo
treponemozo	treponemozo
triado	triado
triakontano	triakontano
tribadismo	tribadismo
tribometrio	tribometrio
triceratopo	triceratopo
triftongo	triftongo
trigledoj	trigledoj
trigonelo	trigonelo
triketro	triketro
trikofito	trikofito
trikofitozo	trikofitozo
trikolomo	trikolomo
trikomicetozo	trikomicetozo
trikopatio	trikopatio
trikoplazio	trikoplazio
trikopteroj	trikopteroj
trikozo	trikozo
trikuspida	trikuspida
trikvetro	trikvetro
trilio	trilio
triplikato	triplikato
triploida	triploida
tripsinogeno	tripsinogeno
triptofano	triptofano
trismo	trismo
trisoma	trisoma
triteto	triteto
tritio	tritio
triulo	triulo
triĥo	triĥo
triĥofito	triĥofito
triĥopteroj	triĥopteroj
trofio	trofio
trofoneŭrozo	trofoneŭrozo
trogio	trogio
trogono	trogono
trogonoformaj	trogonoformaj
trokantero	trokantero
trokaro	trokaro
trokitero	trokitero
trokleo	trokleo
trolio	trolio
trombektomio	trombektomio
trombidiedoj	trombidiedoj
trombidio	trombidio
trombidiozo	trombidiozo
trombino	trombino
trombocito	trombocito
tromelo	tromelo
tropidonoto	tropidonoto
trotuarumi	trotuarumi
trovitejo	trovitejo
trumpo	trumpo
truskeno	truskeno
tsetseo	tsetseo
tuberkulinizado	tuberkulinizado
tuberkulizado	tuberkulizado
tuberkuloza	tuberkuloza
tufiĝanta	tufiĝanta
tujano	tujano
tujolo	tujolo
tujono	tujono
tujopso	tujopso
tukuo	tukuo
tularemio	tularemio
tulua	tulua
tuluo	tuluo
turbelarioj	turbelarioj
turbida	turbida
turbido	turbido
turbidtavolo	turbidtavolo
turdedoj	turdedoj
turga	turga
turgeco	turgeco
turgesko	turgesko
turnedoso	turnedoso
turniketo	turniketo
tvido	tvido
ubikva	ubikva
ublieto	ublieto
udmurto	udmurto
uesto	uesto
ugra	ugra
ugro	ugro
ulvo	ulvo
ulvoficoj	ulvoficoj
umbilikario	umbilikario
umbra	umbra
umbro	umbro
umjako	umjako
umlaŭto	umlaŭto
unaŭo	unaŭo
unciala	unciala
uncialo	uncialo
uncio	uncio
undario	undario
undek	undek
ungolo	ungolo
unitaria	unitaria
unitariismo	unitariismo
unkti	unkti
unuara	unuara
unuto	unuto
uoko	uoko
upasarbo	upasarbo
uperkuto	uperkuto
upupedoj	upupedoj
uracilo	uracilo
urako	urako
uranilo	uranilo
uraninito	uraninito
uranismo	uranismo
uratemio	uratemio
urato	urato
ureazo	ureazo
uredaloj	uredaloj
uredo	uredo
uredosporo	uredosporo
uredosporujo	uredosporujo
ureemio	ureemio
ureuso	ureuso
urgenera	urgenera
urinato	urinato
urinologio	urinologio
urinoreo	urinoreo
urinoskopio	urinoskopio
urlio	urlio
urodeloj	urodeloj
urogenera	urogenera
urografio	urografio
urologio	urologio
urologo	urologo
usklo	usklo
usneo	usneo
ustaŝo	ustaŝo
ustilagaloj	ustilagaloj
ustilago	ustilago
utajo	utajo
uterito	uterito
utriklo	utriklo
utrikulario	utrikulario
uveito	uveito
uveo	uveo
uvo	uvo
uzanco	uzanco
vadjango	vadjango
vaginalgio	vaginalgio
vaginalito	vaginalito
vaginalo	vaginalo
vagotomio	vagotomio
vaiŝjo	vaiŝjo
vajda	vajda
vajdblua	vajdblua
vajdo	vajdo
vajro	vajro
vakameo	vakameo
vakario	vakario
vakuolo	vakuolo
vakŭo	vakŭo
valerianelo	valerianelo
valerlaktono	valerlaktono
valga	valga
vampo	vampo
vandao	vandao
vanilino	vanilino
vanui	vanui
vaporizi	vaporizi
varanedoj	varanedoj
varioloido	varioloido
varleto	varleto
varmoestiga	varmoestiga
varmumi	varmumi
vaskularizi	vaskularizi
vaskulito	vaskulito
vaskulizi	vaskulizi
vazistaso	vazistaso
vazopresino	vazopresino
vedanto	vedanto
veksilo	veksilo
veksilologio	veksilologio
velkozo	velkozo
velŝo	velŝo
venebla	venebla
venerea	venerea
venerologio	venerologio
veprejo	veprejo
verbesino	verbesino
verbezeno	verbezeno
verismo	verismo
vermiso	vermiso
vernalizi	vernalizi
vernalizo	vernalizo
verticilio	verticilio
vertigo	vertigo
vertiĉo	vertiĉo
vertrago	vertrago
verugao	verugao
verukozo	verukozo
verumontanito	verumontanito
verumontano	verumontano
veselo	veselo
vespedoj	vespedoj
vespertilionedoj	vespertilionedoj
vespertiliono	vespertiliono
vet	vet
vezanio	vezanio
vibracio	vibracio
vibratoro	vibratoro
vibrio	vibrio
vibriso	vibriso
viglado	viglado
vigno	vigno
vikara	vikara
vikstremio	vikstremio
viktualio	viktualio
villo	villo
vimplo	vimplo
vincetoksiko	vincetoksiko
vinkamino	vinkamino
vinkulo	vinkulo
vinologio	vinologio
violente	violente
violenti	violenti
violento	violento
vipako	vipako
viperedoj	viperedoj
virgino	virgino
virialo	virialo
virjono	virjono
virozo	virozo
virulenteco	virulenteco
virusologio	virusologio
virusozo	virusozo
viruŝo	viruŝo
virĝinalo	virĝinalo
visigoto	visigoto
viskeca	viskeca
vitacoj	vitacoj
vitaminologio	vitaminologio
vitelo	vitelo
vitiligo	vitiligo
vitologio	vitologio
vitrea	vitrea
vitreo	vitreo
vivario	vivario
viveredoj	viveredoj
vivulicido	vivulicido
vjelo	vjelo
voandzeo	voandzeo
vobli	vobli
vobligi	vobligi
vobligilo	vobligilo
vojevodio	vojevodio
vokoido	vokoido
volteo	volteo
volv	volv
volvarielo	volvarielo
vorko	vorko
vormiano	vormiano
vorticelo	vorticelo
vuajerismo	vuajerismo
vukerio	vukerio
vulkanologio	vulkanologio
vultua	vultua
vulvito	vulvito
zabajono	zabajono
zakusko	zakusko
zapi	zapi
zaporogo	zaporogo
zeino	zeino
zekino	zekino
zelkovo	zelkovo
zemstvo	zemstvo
zenano	zenano
zendo	zendo
zeo	zeo
zeolito	zeolito
zepto	zepto
zeta	zeta
zeŭsedoj	zeŭsedoj
zeŭsoformaj	zeŭsoformaj
zidovudino	zidovudino
zigeno	zigeno
zigofilo	zigofilo
zigomicetoj	zigomicetoj
zigomikotoj	zigomikotoj
zigosporo	zigosporo
zigurato	zigurato
zigzaĝo	zigzaĝo
zimo	zimo
zinkato	zinkato
zooforma	zooforma
zooloĝo	zooloĝo
zoomorfa	zoomorfa
ĉalazio	ĉalazio
ĉambrumi	ĉambrumi
ĉanojo	ĉanojo
ĉardo	ĉardo
ĉarelo	ĉarelo
ĉarlestono	ĉarlestono
ĉastuŝko	ĉastuŝko
ĉatelperonio	ĉatelperonio
ĉato	ĉato
ĉelologio	ĉelologio
ĉementi	ĉementi
ĉemento	ĉemento
ĉerimolibero	ĉerimolibero
ĉerimolio	ĉerimolio
ĉerimoliujo	ĉerimoliujo
ĉernozio	ĉernozio
ĉervonco	ĉervonco
ĉetio	ĉetio
ĉetniko	ĉetniko
ĉevioto	ĉevioto
ĉevronumita	ĉevronumita
ĉibuko	ĉibuko
ĉiesulo	ĉiesulo
ĉiklo	ĉiklo
ĉimozino	ĉimozino
ĉinologio	ĉinologio
ĉiomo	ĉiomo
ĉireto	ĉireto
ĉirimeno	ĉirimeno
ĉirkaŭumo	ĉirkaŭumo
ĉistero	ĉistero
ĉopero	ĉopero
ĉopsuo	ĉopsuo
ĉotedoj	ĉotedoj
ĉurovoj	ĉurovoj
ĝainismo	ĝainismo
ĝaino	ĝaino
ĝartero	ĝartero
ĝemina	ĝemina
ĝeminda	ĝeminda
ĝeneco	ĝeneco
ĝenio	ĝenio
ĝerbosoj	ĝerbosoj
ĝermanida	ĝermanida
ĝermeno	ĝermeno
ĝesto	ĝesto
ĝinfizo	ĝinfizo
ĝinno	ĝinno
ĝirafedoj	ĝirafedoj
ĥalazio	ĥalazio
ĥalkolitiko	ĥalkolitiko
ĥamsino	ĥamsino
ĥasidismo	ĥasidismo
ĥasido	ĥasido
ĥato	ĥato
ĥedero	ĥedero
ĥelicero	ĥelicero
ĥeliceruloj	ĥeliceruloj
ĥeto	ĥeto
ĥetognatoj	ĥetognatoj
ĥilo	ĥilo
ĥilopodoj	ĥilopodoj
ĥironekto	ĥironekto
ĥiropteroj	ĥiropteroj
ĥirurĝo	ĥirurĝo
ĥitino	ĥitino
ĥoano	ĥoano
ĥondrosteoj	ĥondrosteoj
ĥondrostomo	ĥondrostomo
ĥordo	ĥordo
ĥorduloj	ĥorduloj
ĥoto	ĥoto
ĵakarda	ĵakarda
ĵakardo	ĵakardo
ĵamado	ĵamado
ĵami	ĵami
ĵaro	ĵaro
ĵinglo	ĵinglo
ĵinso	ĵinso
ĵokero	ĵokero
ĵoruro	ĵoruro
ĵurasia	ĵurasia
ĵurasio	ĵurasio
ĵurnalistumo	ĵurnalistumo
ĵuĵicuo	ĵuĵicuo
ŝabato	ŝabato
ŝadufo	ŝadufo
ŝakdoo	ŝakdoo
ŝaktio	ŝaktio
ŝakuhaĉo	ŝakuhaĉo
ŝakumita	ŝakumita
ŝakŝuko	ŝakŝuko
ŝamigi	ŝamigi
ŝamoto	ŝamoto
ŝankroida	ŝankroida
ŝanĉo	ŝanĉo
ŝaptali	ŝaptali
ŝarĝatoro	ŝarĝatoro
ŝaĥo	ŝaĥo
ŝaŝliko	ŝaŝliko
ŝedo	ŝedo
ŝeklo	ŝeklo
ŝevioto	ŝevioto
ŝiboleto	ŝiboleto
ŝibui	ŝibui
ŝibuo	ŝibuo
ŝilinĝo	ŝilinĝo
ŝiokaro	ŝiokaro
ŝkopi	ŝkopi
ŝkopo	ŝkopo
ŝlemilo	ŝlemilo
ŝmalci	ŝmalci
ŝmalco	ŝmalco
ŝnapso	ŝnapso
ŝnurumo	ŝnurumo
ŝorto	ŝorto
ŝotro	ŝotro
ŝov	ŝov
ŝoĥti	ŝoĥti
ŝoĥtisto	ŝoĥtisto
ŝoĵio	ŝoĵio
ŝproso	ŝproso
ŝramanismo	ŝramanismo
ŝramano	ŝramano
ŝraŭbaĵilo	ŝraŭbaĵilo
ŝraŭbinigi	ŝraŭbinigi
ŝraŭbinigilo	ŝraŭbinigilo
ŝriki	ŝriki
ŝrotaĵo	ŝrotaĵo
ŝroto	ŝroto
ŝtanci	ŝtanci
ŝtancilo	ŝtancilo
ŝtoko	ŝtoko
ŝtrebo	ŝtrebo
ŝtudo	ŝtudo
ŝudro	ŝudro
ŝunjato	ŝunjato
ŝusado	ŝusado
ŝusi	ŝusi
ŝuso	ŝuso
ŝuŝi	ŝuŝi
ŝuŝo	ŝuŝo
ŝvarcaĵo	ŝvarcaĵo
ŝvebero	ŝvebero
