表示語	解析語
PEJVO.txt (単語数・正規化後ユニーク): 37,434	PEJVO.txt (単語数・正規化後ユニーク): 37,434
差集合 (PIVのみ): 12,964	差集合 (PIVのみ): 12,964
Aarono	Aarono
Abadono	Abadono
Abelardo	Abelardo
Abnero	Abnero
Abrahama	Abrahama
Abruzo	Abruzo
Abŝalomo	Abŝalomo
Aciso	Aciso
Adena	Adena
Adisono	Adisono
ADP	ADP
Adria	Adria
Adriano	Adriano
Afaro	Afaro
Aglajo	Aglajo
Agnio	Agnio
Agrikolo	Agrikolo
Ahasvero	Ahasvero
Akerono	Akerono
Akteono	Akteono
Akvilono	Akvilono
Akvinano	Akvinano
Alariko	Alariko
Albertino	Albertino
Albiono	Albiono
Alcestiso	Alcestiso
Alcibiado	Alcibiado
Alcinoo	Alcinoo
Aleutoj	Aleutoj
Aleĉjo	Aleĉjo
Alfonsino	Alfonsino
Alfonso	Alfonso
Alhambro	Alhambro
Alkajo	Alkajo
Alkmeno	Alkmeno
Almagesto	Almagesto
Amalekidoj	Amalekidoj
Amaleko	Amaleko
Amfitriono	Amfitriono
Amfitrito	Amfitrito
Amonidoj	Amonidoj
Amoso	Amoso
AMP	AMP
Anakreoneska	Anakreoneska
Andromaĥo	Andromaĥo
Angelino	Angelino
Angelo	Angelo
Angura	Angura
Anjo	Anjo
Anselmo	Anselmo
Antinoo	Antinoo
Antiopo	Antiopo
Antioĥio	Antioĥio
Antoneno	Antoneno
Antonenoj	Antonenoj
Anĥizo	Anĥizo
Apiso	Apiso
Apolonio	Apolonio
Argolando	Argolando
Arguso	Arguso
Ariono	Ariono
Ariosto	Ariosto
Aristido	Aristido
Armando	Armando
Artakserkso	Artakserkso
Asamio	Asamio
Asklepio	Asklepio
Asoko	Asoko
Aspazio	Aspazio
Astarto	Astarto
Astianakso	Astianakso
Atalanto	Atalanto
Atikeco	Atikeco
ATP	ATP
Atreidoj	Atreidoj
Atreo	Atreo
Averno	Averno
Averoeso	Averoeso
Avesta	Avesta
Aviceno	Aviceno
AZT	AZT
Aĥabo	Aĥabo
Aĥajano	Aĥajano
Aĥajo	Aĥajo
Aŝmodeo	Aŝmodeo
Aŭgio	Aŭgio
Aŭreliano	Aŭreliano
Aŭstronezia	Aŭstronezia
Baalo	Baalo
Badenlando	Badenlando
Bafina	Bafina
Baktro	Baktro
Bakĥa	Bakĥa
Bakĥanto	Bakĥanto
Bakĥi	Bakĥi
Bakĥofesto	Bakĥofesto
Baldueno	Baldueno
Baltazaro	Baltazaro
Banaĥo	Banaĥo
Barabaso	Barabaso
Barbaroso	Barbaroso
Barenca	Barenca
Barnabanoj	Barnabanoj
Barnabo	Barnabo
Bartolomeo	Bartolomeo
Baruĥo	Baruĥo
Bassa	Bassa
Bastiano	Bastiano
Baŝkirio	Baŝkirio
Behemoto	Behemoto
Belerofono	Belerofono
Belialo	Belialo
Belzebuto	Belzebuto
Belŝacaro	Belŝacaro
Bengalio	Bengalio
Benjameno	Benjameno
Bernardo	Bernardo
Bertrando	Bertrando
Betanio	Betanio
Bhagavadgito	Bhagavadgito
Bileamo	Bileamo
Bizancio	Bizancio
Bizantio	Bizantio
Blazio	Blazio
Blezio	Blezio
Boazo	Boazo
Bofronta	Bofronta
Bogomilo	Bogomilo
Bokaĉa	Bokaĉa
Bomarŝeo	Bomarŝeo
Bonapartisto	Bonapartisto
Bonifaco	Bonifaco
Bordozio	Bordozio
Boromeo	Boromeo
Botnia	Botnia
Brajto	Brajto
Brandenburga	Brandenburga
Brandenburgio	Brandenburgio
Briareo	Briareo
Brindizio	Brindizio
Brumero	Brumero
Bucefalo	Bucefalo
Budapesto	Budapesto
Burbonoj	Burbonoj
Burgenlando	Burgenlando
Burjatio	Burjatio
Cecilio	Cecilio
Cefizo	Cefizo
Cekropso	Cekropso
Celadono	Celadono
Celesteno	Celesteno
Cezareo	Cezareo
Cibelo	Cibelo
Cido	Cido
Cidono	Cidono
Cinno	Cinno
Cipriano	Cipriano
Circo	Circo
Cirenano	Cirenano
Cis-Jordanio	Cis-Jordanio
Cis-Kaŭkazio	Cis-Kaŭkazio
Cisterciano	Cisterciano
Cistercio	Cistercio
Citera	Citera
Dafniso	Dafniso
Dagoberto	Dagoberto
Dakio	Dakio
Daltono	Daltono
Damiano	Damiano
Damoklo	Damoklo
Danaidinoj	Danaidinoj
Danaidoj	Danaidoj
Danao	Danao
Danteca	Danteca
Danteska	Danteska
Daŭfenio	Daŭfenio
Daŭfenlando	Daŭfenlando
DDT	DDT
Dedalo	Dedalo
Demetrio	Demetrio
Demosteno	Demosteno
Denizo	Denizo
Detrojtrivero	Detrojtrivero
Dezidero	Dezidero
Deŭkaliono	Deŭkaliono
Didono	Didono
Diego	Diego
Diodoro	Diodoro
Diofanto	Diofanto
Diogeno	Diogeno
Diokleciano	Diokleciano
Diomedo	Diomedo
Dioniza	Dioniza
Dionizio	Dionizio
Diono	Diono
Dioskuroj	Dioskuroj
Diĵonio	Diĵonio
DNA	DNA
Domiciano	Domiciano
Doria	Doria
Doro	Doro
Dovro	Dovro
Dumao	Dumao
Eako	Eako
Edao	Edao
Edmundo	Edmundo
Eduardo	Eduardo
Efraimo	Efraimo
Efrato	Efrato
Egerio	Egerio
Egisto	Egisto
Eleŭziso	Eleŭziso
Eliezero	Eliezero
Elio	Elio
Elizabeta	Elizabeta
Elizo	Elizo
Elohima	Elohima
Elohimisto	Elohimisto
Emanuelo	Emanuelo
Emauso	Emauso
Emeriko	Emeriko
Emilia	Emilia
Emiliano	Emiliano
Eminjo	Eminjo
Empedoklo	Empedoklo
Endimiono	Endimiono
Eneido	Eneido
Englujo	Englujo
Eolia	Eolia
Eoliano	Eoliano
Eolio	Eolio
Epaminondo	Epaminondo
Epikteto	Epikteto
Erato	Erato
Erebo	Erebo
Erfurto	Erfurto
Erinio	Erinio
Erino	Erino
Erivano	Erivano
Erlango	Erlango
Ernestino	Ernestino
Esavo	Esavo
Eskulapo	Eskulapo
Eskvilino	Eskvilino
Esĥilo	Esĥilo
Eteoklo	Eteoklo
Evelino	Evelino
Evemerismo	Evemerismo
Evemero	Evemero
Ezekielo	Ezekielo
Ezopa	Ezopa
Eŭdokso	Eŭdokso
Eŭfrozino	Eŭfrozino
Eŭgeno	Eŭgeno
Eŭmenidoj	Eŭmenidoj
Eŭmeo	Eŭmeo
Eŭridico	Eŭridico
Eŭripido	Eŭripido
Eŭterpo	Eŭterpo
Fabio	Fabio
Fabricio	Fabricio
Farnezo	Farnezo
Faroso	Faroso
Feba	Feba
Febo	Febo
Fedro	Fedro
Feroa	Feroa
Feroio	Feroio
Fidio	Fidio
Filemono	Filemono
Filipio	Filipio
Filipo	Filipo
Filokteto	Filokteto
Filomelo	Filomelo
Filono	Filono
Firmiano	Firmiano
Flaminio	Flaminio
Flavio	Flavio
Flegetono	Flegetono
Florealo	Florealo
Floriano	Floriano
Fortunato	Fortunato
Franc-Jozefa	Franc-Jozefa
Franclingvio	Franclingvio
Freŝeo	Freŝeo
FRG	FRG
Frigio	Frigio
Frimero	Frimero
Frino	Frino
Frisujo	Frisujo
Fruktidoro	Fruktidoro
Ftio	Ftio
Galateo	Galateo
Galegujo	Galegujo
Galileano	Galileano
Gambrino	Gambrino
Gargantua	Gargantua
Gaŭtamao	Gaŭtamao
GDR	GDR
Gebro	Gebro
Gelfo	Gelfo
Gerardo	Gerardo
Geriono	Geriono
Germanlingvio	Germanlingvio
Geronto	Geronto
Gervazo	Gervazo
Geŭzo	Geŭzo
Gibelino	Gibelino
Gideono	Gideono
Gigeso	Gigeso
Gileado	Gileado
Godfredo	Godfredo
Golgoti	Golgoti
Golĝo	Golĝo
Gongoro	Gongoro
Gontrano	Gontrano
Gonzago	Gonzago
Gorgio	Gorgio
Grala	Grala
Gralo	Gralo
Graŭbindo	Graŭbindo
Gregoria	Gregoria
Gustavino	Gustavino
Gustavo	Gustavo
Guĝaratio	Guĝaratio
Gvebro	Gvebro
Hadriana	Hadriana
Hadriano	Hadriano
Hagado	Hagado
Hagaro	Hagaro
Halepo	Halepo
Hamano	Hamano
Hamilkaro	Hamilkaro
Hanovrano	Hanovrano
Hanovrio	Hanovrio
Haroldo	Haroldo
Harun-al-Raŝido	Harun-al-Raŝido
Hasdrubalo	Hasdrubalo
Hebo	Hebo
Hedvigo	Hedvigo
Hegelano	Hegelano
Hekateo	Hekateo
Hekato	Hekato
Hekubo	Hekubo
Helenistiko	Helenistiko
Helenjo	Helenjo
Heliodoro	Heliodoro
Henjo	Henjo
Heraklidoj	Heraklidoj
Herberto	Herberto
Herkula	Herkula
Herkulano	Herkulano
Herkuleso	Herkuleso
Hermano	Hermano
Hermesbusto	Hermesbusto
Hermiono	Hermiono
Hermito	Hermito
Hermo	Hermo
Hermono	Hermono
Hero	Hero
Herodano	Herodano
Heslando	Heslando
Hesperidinoj	Hesperidinoj
Hesujo	Hesujo
Hevisido	Hevisido
Hiadoj	Hiadoj
Hilberto	Hilberto
Hiperboreoj	Hiperboreoj
Hipokrata	Hipokrata
Hipolito	Hipolito
Hipomeno	Hipomeno
Hipono	Hipono
Hirkano	Hirkano
Hispaniolo	Hispaniolo
Hitlera	Hitlera
Hitlerano	Hitlerano
Hohencolernoj	Hohencolernoj
Hohenstaŭfoj	Hohenstaŭfoj
Holoferno	Holoferno
Holstinio	Holstinio
Honorio	Honorio
Horna	Horna
Hoĝkino	Hoĝkino
Huberto	Huberto
Huso	Huso
Iberujo	Iberujo
Ibliso	Ibliso
Ibseno	Ibseno
Idao	Idao
Idomeneo	Idomeneo
Iduo	Iduo
Ifigenio	Ifigenio
Ignaco	Ignaco
Ijobo	Ijobo
Iksiono	Iksiono
Iliono	Iliono
Ilzo	Ilzo
Inaĥo	Inaĥo
Indianisto	Indianisto
Indoĉina	Indoĉina
Ireneo	Ireneo
Ireno	Ireno
Isaako	Isaako
Isaĥaro	Isaĥaro
Iskarioto	Iskarioto
Ismailo	Ismailo
Israfilo	Israfilo
Isso	Isso
Izengrino	Izengrino
Izidoro	Izidoro
Iziso	Iziso
Izokrato	Izokrato
Izoldo	Izoldo
Izraela	Izraela
Izraelido	Izraelido
Iŝmaelo	Iŝmaelo
Jadvigo	Jadvigo
Jadvinjo	Jadvinjo
Jafetida	Jafetida
Jagelonoj	Jagelonoj
Jakobino	Jakobino
Jakobisto	Jakobisto
Jakutio	Jakutio
Janjo	Janjo
Janseno	Janseno
Javea	Javea
Javeisto	Javeisto
Jazono	Jazono
Jaĉjo	Jaĉjo
Jehoaŝo	Jehoaŝo
Jehoŝafato	Jehoŝafato
Jeriĥa	Jeriĥa
Jerobeamo	Jerobeamo
Jersino	Jersino
Jesŭo	Jesŭo
Jeĥezkelo	Jeĥezkelo
JHVH	JHVH
Jiftaĥo	Jiftaĥo
Jiŝajo	Jiŝajo
Joabo	Joabo
Joakimo	Joakimo
Jobo	Jobo
Joelo	Joelo
Johan-Baptisto	Johan-Baptisto
Johanino	Johanino
Jokasto	Jokasto
Jonatano	Jonatano
Jovo	Jovo
Joĉjo	Joĉjo
Judujo	Judujo
Jugurto	Jugurto
Jukatanio	Jukatanio
Jukonio	Jukonio
Juliino	Juliino
Justeno	Justeno
Justiniano	Justiniano
Juvenalo	Juvenalo
Kaabo	Kaabo
Kabilio	Kabilio
Kabilujo	Kabilujo
Kadmo	Kadmo
Kafrio	Kafrio
Kainidoj	Kainidoj
Kaistro	Kaistro
Kalibano	Kalibano
Kaligulo	Kaligulo
Kalimaĥo	Kalimaĥo
Kaliopo	Kaliopo
Kalisto	Kalisto
Kalmukio	Kalmukio
Kaloĉaja	Kaloĉaja
Kalvaria	Kalvaria
Kalĥaso	Kalĥaso
Kamadevo	Kamadevo
Kamasutraĵo	Kamasutraĵo
Kambizo	Kambizo
Kamilo	Kamilo
Kamoenso	Kamoenso
Kampuĉeo	Kampuĉeo
Kanaana	Kanaana
Kanakio	Kanakio
Kantiano	Kantiano
Kapadocio	Kapadocio
Kapetidoj	Kapetidoj
Karaiba	Karaiba
Karakalpakio	Karakalpakio
Karisoj	Karisoj
Karolidoj	Karolidoj
Karonjo	Karonjo
Karpentaria	Karpentaria
Kasandro	Kasandro
Katilino	Katilino
Katono	Katono
Katulo	Katulo
Kaŝubio	Kaŝubio
Kaŭkazio	Kaŭkazio
Keltio	Keltio
Kianto	Kianto
Kijlo	Kijlo
Kirilo	Kirilo
Kirono	Kirono
Klanjo	Klanjo
Klaranino	Klaranino
Klaŭdiano	Klaŭdiano
Klaŭdino	Klaŭdino
Klaŭdio	Klaŭdio
Klaŭdo	Klaŭdo
Kleanto	Kleanto
Klementino	Klementino
Klemento	Klemento
Kleono	Kleono
Klio	Klio
Klitandro	Klitandro
Klitemnestro	Klitemnestro
Klodovaldo	Klodovaldo
Klodvigo	Klodvigo
Klotaro	Klotaro
Klotildo	Klotildo
Kluniza	Kluniza
Kocito	Kocito
Kohinuro	Kohinuro
Kolor	Kolor
Koloseo	Koloseo
Kolĉido	Kolĉido
Kolĥido	Kolĥido
Komilando	Komilando
Kompartio	Kompartio
Komptono	Komptono
Komsomolo	Komsomolo
Konrado	Konrado
Konstanca	Konstanca
Konstancio	Konstancio
Konstanteno	Konstanteno
Kopernika	Kopernika
Koraĥo	Koraĥo
Kordilero	Kordilero
Koriolano	Koriolano
Kornelieca	Kornelieca
Kornelio	Kornelio
Kortesoj	Kortesoj
Koĥo	Koĥo
Koŝio	Koŝio
Kraso	Kraso
Krebso	Krebso
Kreono	Kreono
Krezo	Krezo
Krimhildo	Krimhildo
Kristiano	Kristiano
Krizipo	Krizipo
Krizostomo	Krizostomo
Kronido	Kronido
Ksantipino	Ksantipino
Ksantipo	Ksantipo
Ksanto	Ksanto
Ksenofono	Ksenofono
Kurdujo	Kurdujo
Kuroŝio	Kuroŝio
Kurtio	Kurtio
Kvintiliano	Kvintiliano
Kvinto-Kurtio	Kvinto-Kurtio
Kvirinalo	Kvirinalo
Lacedemonano	Lacedemonano
Lacedemono	Lacedemono
Ladislao	Ladislao
Ladoga	Ladoga
Laerto	Laerto
Lajo	Lajo
Laknaŭo	Laknaŭo
Lamberto	Lamberto
Lanko	Lanko
Laodikeo	Laodikeo
Laokoono	Laokoono
Laplando	Laplando
Laroŝfuko	Laroŝfuko
Latiano	Latiano
Latio	Latio
Leopoldino	Leopoldino
Lepido	Lepido
Lesbanino	Lesbanino
Lesbano	Lesbano
Leteo	Leteo
Leto	Leto
Leviido	Leviido
Leŭkado	Leŭkado
Lidiano	Lidiano
Ligurujo	Ligurujo
Likio	Likio
Likurgo	Likurgo
Limoĝio	Limoĝio
Livonujo	Livonujo
Lizipo	Lizipo
Logano	Logano
Lombardujo	Lombardujo
Lorenano	Lorenano
Lotaringo	Lotaringo
Lotario	Lotario
LSD	LSD
Luareto	Luareto
Luarvalo	Luarvalo
Lubo	Lubo
Luciano	Luciano
Lucilio	Lucilio
Lucino	Lucino
Lucio	Lucio
Ludovikino	Ludovikino
Luiso	Luiso
Lukanio	Lukanio
Lukrecio	Lukrecio
Lukulo	Lukulo
Lumbino	Lumbino
Luziado	Luziado
Luzido	Luzido
Luzidoj	Luzidoj
Luzo	Luzo
Madano	Madano
Mahaviro	Mahaviro
Majmonido	Majmonido
Majoto	Majoto
Makabeo	Makabeo
Makabeoj	Makabeoj
Makaronezio	Makaronezio
Maksimiliano	Maksimiliano
Makso	Makso
Malpigo	Malpigo
Manituo	Manituo
Maniĥeano	Maniĥeano
Maniĥeismo	Maniĥeismo
Maniĥeo	Maniĥeo
Manjo	Manjo
Mansio	Mansio
Manuelo	Manuelo
Manuo	Manuo
Marcialo	Marcialo
Mariano	Mariano
Mariujo	Mariujo
Mark-Aŭrelio	Mark-Aŭrelio
Marteno	Marteno
Marŝ	Marŝ
Masilio	Masilio
Mazdaismo	Mazdaismo
Mazdaisto	Mazdaisto
Mazdao	Mazdao
Mazepo	Mazepo
Maŭrico	Maŭrico
Me	Me
Mecenaso	Mecenaso
Medeo	Medeo
Mediĉoj	Mediĉoj
Medujo	Medujo
Mejbomo	Mejbomo
Meklenburgio-Antaŭpomerio	Meklenburgio-Antaŭpomerio
Melkicedeko	Melkicedeko
Melkioro	Melkioro
Meloso	Meloso
Melpomeno	Melpomeno
Meluzino	Meluzino
Menandro	Menandro
Menelao	Menelao
Merkurio	Merkurio
Merovidoj	Merovidoj
Merovo	Merovo
Mesalino	Mesalino
Mesia	Mesia
Mesiado	Mesiado
Mesidoro	Mesidoro
Metuŝelaĥo	Metuŝelaĥo
Meĥleno	Meĥleno
Mickjeviĉo	Mickjeviĉo
Mikaelo	Mikaelo
Milanio	Milanio
Miltiado	Miltiado
Minoa	Minoa
Mitraejo	Mitraejo
Mitraismo	Mitraismo
Mitraisto	Mitraisto
Moabido	Moabido
Moabo	Moabo
Mogola	Mogola
Moliso	Moliso
Moloĥo	Moloĥo
Mordeĥajo	Mordeĥajo
Mordvio	Mordvio
Morfeo	Morfeo
Morgano	Morgano
MOS	MOS
Mosea	Mosea
Mozelvino	Mozelvino
Naboto	Naboto
Napluso	Napluso
Napoleona	Napoleona
Napoleonidoj	Napoleonidoj
Natano	Natano
Naĥumo	Naĥumo
Neguso	Neguso
Nemeo	Nemeo
Nemezo	Nemezo
Nepero	Nepero
Nereidinoj	Nereidinoj
Nerona	Nerona
Neso	Neso
Nestorio	Nestorio
Nestoro	Nestoro
Nibelungoj	Nibelungoj
Niceo	Niceo
Nikolaitoj	Nikolaitoj
Nimo	Nimo
Nimrodo	Nimrodo
Nivozo	Nivozo
Niĉeismo	Niĉeismo
Nonoj	Nonoj
Nord	Nord
Normandia	Normandia
Norno	Norno
Novisado	Novisado
Numo	Numo
Ohiorivero	Ohiorivero
Okcitanio	Okcitanio
Oktavio	Oktavio
Omajadoj	Omajadoj
Omfalo	Omfalo
OMS	OMS
Onano	Onano
Onezimo	Onezimo
Oranĝio	Oranĝio
Oresto	Oresto
Orfea	Orfea
Origeno	Origeno
Orisio	Orisio
Orleanio	Orleanio
Ormazdo	Ormazdo
Osetio	Osetio
Osiano	Osiano
Osvaldo	Osvaldo
Ovidio	Ovidio
Oĥotska	Oĥotska
Padio	Padio
Palaso	Palaso
Pamplono	Pamplono
Panmunĵono	Panmunĵono
Panonio	Panonio
Pantagruelo	Pantagruelo
Panurgo	Panurgo
Panĝabio	Panĝabio
Papu-Nov-Gvineo	Papu-Nov-Gvineo
Paragvaĵo	Paragvaĵo
Parakleto	Parakleto
Paralipomenoj	Paralipomenoj
Parcino	Parcino
Parizio	Parizio
Parma	Parma
Parmenido	Parmenido
Parsia	Parsia
Parsiismo	Parsiismo
Parsio	Parsio
Pasteŭra	Pasteŭra
Patroklo	Patroklo
Patronia	Patronia
Pazifao	Pazifao
Paŭlanismo	Paŭlanismo
Paŭlano	Paŭlano
Paŭlino	Paŭlino
Paŭzanio	Paŭzanio
Pelagio	Pelagio
Peleido	Peleido
Peleo	Peleo
Pelopso	Pelopso
Pentekostano	Pentekostano
Pentezileo	Pentezileo
Percevalo	Percevalo
Pergamo	Pergamo
Perigozio	Perigozio
Periklo	Periklo
Perpetuo	Perpetuo
Persujo	Persujo
Peruĝano	Peruĝano
Perŭo	Perŭo
Petrarkeca	Petrarkeca
Petrarkeska	Petrarkeska
Petrarkismo	Petrarkismo
Petrarkumi	Petrarkumi
Petrogrado	Petrogrado
Petronio	Petronio
Peĉjo	Peĉjo
pH	pH
Pilado	Pilado
Pindaro	Pindaro
Pipino	Pipino
Piramo	Piramo
Piritoo	Piritoo
Pirono	Pirono
Pirro	Pirro
Pitia	Pitia
Pitio	Pitio
Pizistrato	Pizistrato
Pizono	Pizono
pK	pK
Placido	Placido
Plata-urbo	Plata-urbo
Plateo	Plateo
Plaŭto	Plaŭto
Plejadoj	Plejadoj
Plinio	Plinio
Plutarĥo	Plutarĥo
Pluviozo	Pluviozo
Podgorico	Podgorico
Polibio	Polibio
Polieŭkto	Polieŭkto
Polifemo	Polifemo
Poliklito	Poliklito
Polikrato	Polikrato
Polikseno	Polikseno
Polimnio	Polimnio
Pompeo	Pompeo
Poncio	Poncio
Pont-Eŭkseno	Pont-Eŭkseno
Pontino	Pontino
Potsdamo	Potsdamo
Potto	Potto
Praksitelo	Praksitelo
Prerialo	Prerialo
Priapa	Priapa
Priapo	Priapo
Prokno	Prokno
Prokusto	Prokusto
Protea	Protea
Providenĉo	Providenĉo
Ptolemea	Ptolemea
Punika	Punika
Puranoj	Puranoj
Purimo	Purimo
Purkinjo	Purkinjo
Racino	Racino
Radamantiso	Radamantiso
Rafaeleca	Rafaeleca
Rajmondo	Rajmondo
Raulo	Raulo
Raĝastano	Raĝastano
Reaŭmuro	Reaŭmuro
Redemptoro	Redemptoro
Rejnaldo	Rejnaldo
Rejnlando	Rejnlando
Renato	Renato
Renesanĉo	Renesanĉo
Retio	Retio
Rinaldo	Rinaldo
RNA	RNA
Rodoso	Rodoso
Rodrigo	Rodrigo
Rogacio	Rogacio
Rolando	Rolando
Rom-Germana	Rom-Germana
Romandio	Romandio
Romanĉio	Romanĉio
Ronsardo	Ronsardo
Roĝero	Roĝero
Rusiljono	Rusiljono
Rutenujo	Rutenujo
Sabenujo	Sabenujo
Sadio	Sadio
Saksujo	Saksujo
Salamiso	Salamiso
Sankta-Georgo	Sankta-Georgo
Sankta-Johano	Sankta-Johano
Sankta-Lucio	Sankta-Lucio
Sansimonisto	Sansimonisto
Sanĥeribo	Sanĥeribo
Sardanapalo	Sardanapalo
Sardeso	Sardeso
Sardujo	Sardujo
Sarlando	Sarlando
Sarmatujo	Sarmatujo
Saro	Saro
Sartra	Sartra
Sasanidoj	Sasanidoj
Saulo	Saulo
Savoja	Savoja
Saŭlo	Saŭlo
Sebastiano	Sebastiano
Semelo	Semelo
Semiramiso	Semiramiso
Septuaginto	Septuaginto
Sidonio	Sidonio
Sidono	Sidono
Sigismondo	Sigismondo
Siksto	Siksto
Simeono	Simeono
Simonido	Simonido
Siro	Siro
Sirtoj	Sirtoj
Sisterono	Sisterono
Siu-urbo	Siu-urbo
Sizifa	Sizifa
Siĥemo	Siĥemo
Skitio	Skitio
Socinanismo	Socinanismo
Socinano	Socinano
Socinismo	Socinismo
Socino	Socino
Sokotro	Sokotro
Sokrata	Sokrata
Solimano	Solimano
Solono	Solono
Sonjo	Sonjo
Sorabio	Sorabio
Spartakano	Spartakano
Spartakisto	Spartakisto
Stanislao	Stanislao
Staĥanovo	Staĥanovo
Stefanino	Stefanino
Stentoro	Stentoro
Stikso	Stikso
Stimfalo	Stimfalo
Stuartoj	Stuartoj
Sud-Tirolo	Sud-Tirolo
Suetonio	Suetonio
Sullo	Sullo
Sulpicio	Sulpicio
Suzio	Suzio
Taboro	Taboro
Tadeo	Tadeo
Tamulio	Tamulio
Tanganjikio	Tanganjikio
Tantrismo	Tantrismo
Tantroj	Tantroj
Tarkvinio	Tarkvinio
Tarpejo	Tarpejo
Tartaro	Tartaro
Tartufo	Tartufo
Tarŝiŝo	Tarŝiŝo
Tasso	Tasso
Tatario	Tatario
Tatarujo	Tatarujo
Tebaido	Tebaido
Teguo	Teguo
Tehrano	Tehrano
Telemaĥo	Telemaĥo
Temistoklo	Temistoklo
Teodiceo	Teodiceo
Teodozia	Teodozia
Teodozio	Teodozio
Teofilo	Teofilo
Teogniso	Teogniso
Teokrito	Teokrito
Terencio	Terencio
Termidoro	Termidoro
Termopiloj	Termopiloj
Terpsikoro	Terpsikoro
Tertuliano	Tertuliano
Tespiso	Tespiso
Tetiso	Tetiso
Tiberio	Tiberio
Tibulo	Tibulo
Ticiano	Ticiano
Tiesto	Tiesto
Timoteo	Timoteo
Tirena	Tirena
Tirezio	Tirezio
Tirola	Tirola
Tirteo	Tirteo
Tisbo	Tisbo
Tito-Livio	Tito-Livio
TNT	TNT
Tobio	Tobio
Toluo	Toluo
Tomisto	Tomisto
Tomo	Tomo
Torkemado	Torkemado
Toskanujo	Toskanujo
Toto	Toto
Trajano	Trajano
Trans-Kaŭkazio	Trans-Kaŭkazio
Trentio	Trentio
Trinitatano	Trinitatano
Trinitato	Trinitato
Tripolio	Tripolio
Triptolemo	Triptolemo
Trismegisto	Trismegisto
Tristano	Tristano
Troado	Troado
Troilo	Troilo
Troja	Troja
Trojanoj	Trojanoj
Trojio	Trojio
Tucidido	Tucidido
Tudora	Tudora
Tudoro	Tudoro
Tuilerioj	Tuilerioj
Tuleo	Tuleo
Tullo	Tullo
U-bombo	U-bombo
Udmurtio	Udmurtio
Umaro	Umaro
Unuel	Unuel
Upaniŝadoj	Upaniŝadoj
Ursulanino	Ursulanino
Urugvaĵo	Urugvaĵo
Utiko	Utiko
Vagnera	Vagnera
Valaĥujo	Valaĥujo
Valdano	Valdano
Valdemaro	Valdemaro
Valdismo	Valdismo
Valdo	Valdo
Valenciena	Valenciena
Valentiniano	Valentiniano
Valerio	Valerio
Valezianoj	Valezianoj
Valpurga	Valpurga
Valpurgo	Valpurgo
Van-Dejka	Van-Dejka
Varanasio	Varanasio
Varuno	Varuno
Vasermano	Vasermano
Veda	Veda
Vedoj	Vedoj
Venceslao	Venceslao
Vendeano	Vendeano
Vendemiero	Vendemiero
Ventozo	Ventozo
Veronezo	Veronezo
Vespaziano	Vespaziano
Vezero	Vezero
Viktorina	Viktorina
Virtembergo	Virtembergo
Vitruvio	Vitruvio
Vojvodino	Vojvodino
Volfgango	Volfgango
Vorarlbergo	Vorarlbergo
X-radioj	X-radioj
Zadigo	Zadigo
Zakario	Zakario
Zaratuŝtro	Zaratuŝtro
Zenero	Zenero
Zeŭksiso	Zeŭksiso
Zoharo	Zoharo
Zoilo	Zoilo
Ĉadio	Ĉadio
Ĉadlando	Ĉadlando
Ĉefeĉ-ŝlosilo	Ĉefeĉ-ŝlosilo
Ĉerkesujo	Ĉerkesujo
Ĉestro	Ĉestro
Ĉeviota	Ĉeviota
Ĝafaro	Ĝafaro
Ĝaganato	Ĝaganato
Ĝahano	Ĝahano
Ĝeneralifo	Ĝeneralifo
Ĝenĝis	Ĝenĝis
Ĝeraldo	Ĝeraldo
Ĝermanio	Ĝermanio
Ĝerminalo	Ĝerminalo
Ĝirondio	Ĝirondio
Ĝofredo	Ĝofredo
Ĝubao	Ĝubao
Ĥabakuko	Ĥabakuko
Ĥagajo	Ĥagajo
Ĥamido	Ĥamido
Ĥanoĥo	Ĥanoĥo
Ĥanuko	Ĥanuko
Ĥaribdo	Ĥaribdo
Ĥatiano	Ĥatiano
Ĥatio	Ĥatio
Ĥimeno	Ĥimeno
Ĥiramo	Ĥiramo
Ĥorebo	Ĥorebo
Ĥorsabado	Ĥorsabado
Ĥuramo	Ĥuramo
Ŝebaismo	Ŝebaismo
Ŝekspira	Ŝekspira
Ŝetlanda	Ŝetlanda
Ŝeĥemo	Ŝeĥemo
Ŝivo	Ŝivo
Ŝjiningo	Ŝjiningo
Ŝlesvigio	Ŝlesvigio
Ŝulamito	Ŝulamito
Ŝunemo	Ŝunemo
Ŝvabio	Ŝvabio
Ŝvano	Ŝvano
Ŝvanomo	Ŝvanomo
Ŝvarca	Ŝvarca
Ŝvarco	Ŝvarco
