PEJVOにあってvortaro.tsvにない語根: 2730個

語根リスト(例単語付き):
a-vort	# PEJVO例: a-vort/o
a.K.	# PEJVO例: a.K.
abolici	# PEJVO例: abolici/i
aborigen	# PEJVO例: aborigen/o
abstemi	# PEJVO例: abstemi/o
abstinenc	# PEJVO例: abstinenc/o
ac^	# PEJVO例: ac^/a
ac^et	# PEJVO例: ac^et/ad/o
ac^eu^le	# PEJVO例: ac^eu^le/o
acetat	# PEJVO例: acetat/a acid/o
acetil	# PEJVO例: acetil/o
acetilen	# PEJVO例: acetilen/o
aceton	# PEJVO例: aceton/o
adag^	# PEJVO例: adag^/e
adenin	# PEJVO例: adenin/o
adenozin	# PEJVO例: adenozin/o
adenozin-trifosfat	# PEJVO例: adenozin-trifosfat/a
adiau^	# PEJVO例: adiau^
adjudik	# PEJVO例: adjudik/i
administrator	# PEJVO例: administrator/o
admiralitat	# PEJVO例: admiralitat/o
adonid	# PEJVO例: adonid/o
adsorb	# PEJVO例: adsorb/i
advers	# PEJVO例: advers/a
advokat-konsil	# PEJVO例: advokat-konsil/ant/o
aerofagi	# PEJVO例: aerofagi/o
aerometr	# PEJVO例: aerometr/o
aeronau^t	# PEJVO例: aeronau^t/o
aeronau^tik	# PEJVO例: aeronau^tik/o
afis^	# PEJVO例: afis^/ej/o
afrik	# PEJVO例: afrik/a
ag^	# PEJVO例: ag^/a
ag^i	# PEJVO例: ag^i/o
ag^iot	# PEJVO例: ag^iot/i
agap	# PEJVO例: agap/o
agapant	# PEJVO例: agapant/o
agnostikism	# PEJVO例: agnostikism/o
agreg	# PEJVO例: agreg/i
agresiv	# PEJVO例: agresiv/a
ah^	# PEJVO例: ah^
ah^il	# PEJVO例: ah^il/a tenden/o
aha	# PEJVO例: aha
aides	# PEJVO例: aides/o
ain	# PEJVO例: ain/a
aj	# PEJVO例: aj
aj^	# PEJVO例: aj^/et/o
aj^ur	# PEJVO例: aj^ur/a
ajnu	# PEJVO例: ajnu/a
akaj^u	# PEJVO例: akaj^u/arb/o
akil	# PEJVO例: akil/a tenden/o
akirant	# PEJVO例: akirant/o
akrided	# PEJVO例: akrided/oj
aksis	# PEJVO例: aksis/o
akumulator	# PEJVO例: akumulator/o
akus^	# PEJVO例: akus^/a
akuŝ	# PEJVO例: akuŝ/il/o
akĉent	# PEJVO例: akĉent/o
alau^d	# PEJVO例: alau^d/falk/o
alc^emil	# PEJVO例: alc^emil/o
aleman	# PEJVO例: aleman/oj
alfa	# PEJVO例: alfa
alfa-dis	# PEJVO例: alfa-dis/er/ig^/o
alfa-korpuskl	# PEJVO例: alfa-korpuskl/oj
alfa-partikl	# PEJVO例: alfa-partikl/oj
alg^eri	# PEJVO例: alg^eri/an/o
alh^emi	# PEJVO例: alh^emi/o
alkaloid	# PEJVO例: alkaloid/o
almenau^	# PEJVO例: almenau^
along^	# PEJVO例: along^/o
alp	# PEJVO例: alp/a azale/o
alsin	# PEJVO例: alsin/o
alteno	# PEJVO例: alteno
alternanc	# PEJVO例: alternanc/o
alternator	# PEJVO例: alternator/o
altometr	# PEJVO例: altometr/o
altruist	# PEJVO例: altruist/o
ambau^	# PEJVO例: ambau^
ame	# PEJVO例: ame/o
ameboid	# PEJVO例: ameboid/a
amelaz	# PEJVO例: amelaz/o
amendament	# PEJVO例: amendament/o
amerik	# PEJVO例: amerik/a
amfibrah^	# PEJVO例: amfibrah^/o
amianti	# PEJVO例: amianti/o
amorfofal	# PEJVO例: amorfofal/a bulb/o
ampermetr	# PEJVO例: ampermetr/o
amplif	# PEJVO例: amplif/i
amplifikator	# PEJVO例: amplifikator/o
anafilaksi	# PEJVO例: anafilaksi/o
ananas-suk	# PEJVO例: ananas-suk/o
anarh^i	# PEJVO例: anarh^i/o
anarkism	# PEJVO例: anarkism/o
anarkist	# PEJVO例: anarkist/o
anatom	# PEJVO例: anatom/o
anc^	# PEJVO例: anc^/instrument/o
anc^ov	# PEJVO例: anc^ov/o
andaluzi	# PEJVO例: andaluzi/a
aneu^rism	# PEJVO例: aneu^rism/o
ang^el	# PEJVO例: ang^el/a
ang^elus	# PEJVO例: ang^elus/o
angstrom	# PEJVO例: angstrom/o
ankau^	# PEJVO例: ankau^
ankorau^	# PEJVO例: ankorau^
ankorau^ ne	# PEJVO例: ankorau^ ne
ankuz	# PEJVO例: ankuz/o
ann	# PEJVO例: ann/o
anormal	# PEJVO例: anormal/a
anstatau^	# PEJVO例: anstatau^
anstataŭ	# PEJVO例: anstataŭ/iĝ/i
antarkt	# PEJVO例: antarkt/a
antau^	# PEJVO例: antau^
antau^ Krist	# PEJVO例: antau^ Krist/o
antau^ ol	# PEJVO例: antau^ ol
antaŭ	# PEJVO例: antaŭ/o
antem	# PEJVO例: antem/o
antemid	# PEJVO例: antemid/o
anticiklon	# PEJVO例: anticiklon/o
antifraz	# PEJVO例: antifraz/o
antigen	# PEJVO例: antigen/o
antikorp	# PEJVO例: antikorp/o
antikorpuskl	# PEJVO例: antikorpuskl/o
antineu^trin	# PEJVO例: antineu^trin/o
antipartikl	# PEJVO例: antipartikl/o
antiproton	# PEJVO例: antiproton/o
antropomorfism	# PEJVO例: antropomorfism/o
apac^	# PEJVO例: apac^/o
apanag^	# PEJVO例: apanag^/o
apanaĝ	# PEJVO例: apanaĝ/i
apenau^	# PEJVO例: apenau^
apiac	# PEJVO例: apiac/oj
aplau^d	# PEJVO例: aplau^d/i
aplaŭd	# PEJVO例: aplaŭd/ad/o
apne	# PEJVO例: apne/a sindrom/o
apod	# PEJVO例: apod/o
apog^atur	# PEJVO例: apog^atur/o
apret	# PEJVO例: apret/ad/o
apunt	# PEJVO例: apunt/o
araknoid	# PEJVO例: araknoid/o
arame	# PEJVO例: arame/o
arang^	# PEJVO例: arang^/em/a
aranĝ	# PEJVO例: aranĝ/a
arau^kari	# PEJVO例: arau^kari/o
arbitrag^	# PEJVO例: arbitrag^/o
arc^	# PEJVO例: arc^/o
ardizi	# PEJVO例: ardizi/o
arg^ent	# PEJVO例: arg^ent/a
arg^entan	# PEJVO例: arg^entan/o
arg^irol	# PEJVO例: arg^irol/o
argentin	# PEJVO例: argentin/a
argonau^t	# PEJVO例: argonau^t/o
arh^aik	# PEJVO例: arh^aik/a
arh^aism	# PEJVO例: arh^aism/o
arh^eolog	# PEJVO例: arh^eolog/o
arh^eologi	# PEJVO例: arh^eologi/o
arh^ipelag	# PEJVO例: arh^ipelag/o
arh^itekt	# PEJVO例: arh^itekt/o
arh^itektur	# PEJVO例: arh^itektur/o
arh^iv	# PEJVO例: arh^iv/o
ariergard	# PEJVO例: ariergard/o
aristotel	# PEJVO例: aristotel/ism/o
arkiduk	# PEJVO例: arkiduk/o
arkipelag	# PEJVO例: arkipelag/o
arpeg^	# PEJVO例: arpeg^/i
ars^in	# PEJVO例: ars^in/o
artez	# PEJVO例: artez/a
artis^ok	# PEJVO例: artis^ok/o
artiŝok	# PEJVO例: artiŝok/fund/o
artritism	# PEJVO例: artritism/o
arĝent	# PEJVO例: arĝent/ism/o
as-temp	# PEJVO例: as-temp/o
as^kenaz	# PEJVO例: as^kenaz/o
asembl	# PEJVO例: asembl/a lingv/o
asiri	# PEJVO例: asiri/o/log/o
aski	# PEJVO例: aski/a sign/o
asterac	# PEJVO例: asterac/oj
astigmatism	# PEJVO例: astigmatism/o
astrakan	# PEJVO例: astrakan/o
astronau^t	# PEJVO例: astronau^t/o
astronaŭtik	# PEJVO例: astronaŭtik/o
atas^e	# PEJVO例: atas^e/o
atenu	# PEJVO例: atenu/a indic/o
atik	# PEJVO例: atik/a
atletik	# PEJVO例: atletik/o
atm.	# PEJVO例: atm.
atrepsi	# PEJVO例: atrepsi/o
au^	# PEJVO例: au^
au^d	# PEJVO例: au^d/a
au^dac	# PEJVO例: au^dac/a
au^dienc	# PEJVO例: au^dienc/o
au^ditori	# PEJVO例: au^ditori/o
au^gur	# PEJVO例: au^gur/ad/o
au^gust	# PEJVO例: au^gust/o
au^gusten	# PEJVO例: au^gusten/ism/o
au^kci	# PEJVO例: au^kci/i
au^l	# PEJVO例: au^l/o
au^reol	# PEJVO例: au^reol/o
au^rignaci	# PEJVO例: au^rignaci/o
au^rikl	# PEJVO例: au^rikl/o
au^rikul	# PEJVO例: au^rikul/o
au^ror	# PEJVO例: au^ror/o
au^skult	# PEJVO例: au^skult/ad/o
au^spici	# PEJVO例: au^spici/o
au^str	# PEJVO例: au^str/a
au^strali	# PEJVO例: au^strali/a
au^t	# PEJVO例: au^t/ej/o
au^tarci	# PEJVO例: au^tarci/o
au^tent	# PEJVO例: au^tent/a
au^tentik	# PEJVO例: au^tentik/a
au^tism	# PEJVO例: au^tism/a infan/o
au^tobiografi	# PEJVO例: au^tobiografi/o
au^tobus	# PEJVO例: au^tobus/halt/ej/o
au^todafe	# PEJVO例: au^todafe/o
au^todidakt	# PEJVO例: au^todidakt/o
au^togir	# PEJVO例: au^togir/o
au^tograf	# PEJVO例: au^tograf/o
au^tografi	# PEJVO例: au^tografi/o
au^tokrat	# PEJVO例: au^tokrat/ism/o
au^tokrati	# PEJVO例: au^tokrati/o
au^tokton	# PEJVO例: au^tokton/o
au^tomaci	# PEJVO例: au^tomaci/o
au^tomat	# PEJVO例: au^tomat/a
au^tomobil	# PEJVO例: au^tomobil/ism/o
au^tonom	# PEJVO例: au^tonom/a
au^tonomi	# PEJVO例: au^tonomi/o
au^tor	# PEJVO例: au^tor/ekzempler/oj
au^toritat	# PEJVO例: au^toritat/a
au^tun	# PEJVO例: au^tun/a
avangard	# PEJVO例: avangard/a
avantag^	# PEJVO例: avantag^/a
averag^	# PEJVO例: averag^/a
averaĝ	# PEJVO例: averaĝ/o
avers	# PEJVO例: avers/o
avi	# PEJVO例: avi/ad/a
aviad	# PEJVO例: aviad/i
azerbajg^an	# PEJVO例: azerbajg^an/an/o
azi	# PEJVO例: azi/a
aztek	# PEJVO例: aztek/oj
azuki	# PEJVO例: azuki/o
aŭd	# PEJVO例: aŭd/ant/o
aŭgur	# PEJVO例: aŭgur/ist/in/o
aŭk	# PEJVO例: aŭk/o
aŭr	# PEJVO例: aŭr/o
aŭreol	# PEJVO例: aŭreol/i
aŭreomicin	# PEJVO例: aŭreomicin/o
aŭror	# PEJVO例: aŭror/i
aŭskult	# PEJVO例: aŭskult/ant/ar/o
aŭt	# PEJVO例: aŭt/ad/i
aŭtoklav	# PEJVO例: aŭtoklav/i
aŭtokrat	# PEJVO例: aŭtokrat/a
aŭtoliz	# PEJVO例: aŭtoliz/o
aŭtomat	# PEJVO例: aŭtomat/ec/o
aŭtomobil	# PEJVO例: aŭtomobil/a
aŭtonomi	# PEJVO例: aŭtonomi/a
aŭtor	# PEJVO例: aŭtor/a
aŭtoritat	# PEJVO例: aŭtoritat/ec/o
babel	# PEJVO例: babel/ism/o
babus^	# PEJVO例: babus^/o
bac^	# PEJVO例: bac^/o
badminton	# PEJVO例: badminton/o
bagag^	# PEJVO例: bagag^/o
baht	# PEJVO例: baht/o
bakalau^r	# PEJVO例: bakalau^r/ec/o
bakanal	# PEJVO例: bakanal/o
bakteriologi	# PEJVO例: bakteriologi/o
baktri	# PEJVO例: baktri/a kamel/o
baldau^	# PEJVO例: baldau^
balkan	# PEJVO例: balkan/ig/i
bandag^	# PEJVO例: bandag^/i
bandaĝ	# PEJVO例: bandaĝ/ist/o
bandoni	# PEJVO例: bandoni/o
banĝ	# PEJVO例: banĝ/o
barbarism	# PEJVO例: barbarism/o
barc^	# PEJVO例: barc^/o
barg^	# PEJVO例: barg^/o
barjon	# PEJVO例: barjon/o
basedov	# PEJVO例: basedov/a mal/san/o
bau^	# PEJVO例: bau^/o
bau^d	# PEJVO例: bau^d/o
bau^druc^	# PEJVO例: bau^druc^/o
bau^m	# PEJVO例: bau^m/i
baŭksit	# PEJVO例: baŭksit/o
bedau^r	# PEJVO例: bedau^r/at/a
bekerel	# PEJVO例: bekerel/o
bekverel	# PEJVO例: bekverel/o
beletristik	# PEJVO例: beletristik/o
benediktan	# PEJVO例: benediktan/a labor/o
bengal	# PEJVO例: bengal/a lingv/o
benign	# PEJVO例: benign/a
benzoat	# PEJVO例: benzoat/a acid/o
berberisac	# PEJVO例: berberisac/oj
bes^amel	# PEJVO例: bes^amel/a sau^c/o
beta	# PEJVO例: beta
beta-dis	# PEJVO例: beta-dis/er/ig^/o
bibliofili	# PEJVO例: bibliofili/o
bikonkav	# PEJVO例: bikonkav/a
bikonveks	# PEJVO例: bikonveks/a
biks^u	# PEJVO例: biks^u/o
bilg^	# PEJVO例: bilg^/a kil/o
bimetalism	# PEJVO例: bimetalism/o
bio	# PEJVO例: bio/diversec/o
bio-	# PEJVO例: bio-
biocenoz	# PEJVO例: biocenoz/o
biofizik	# PEJVO例: biofizik/o
biogeografi	# PEJVO例: biogeografi/o
biomas	# PEJVO例: biomas/a energi/o
biosfer	# PEJVO例: biosfer/o
biotop	# PEJVO例: biotop/o
birm	# PEJVO例: birm/a lingv/o
bk	# PEJVO例: bk
blenoragi	# PEJVO例: blenoragi/o
blog	# PEJVO例: blog/o
blokhaŭs	# PEJVO例: blokhaŭs/o
bo-	# PEJVO例: bo-
bodi	# PEJVO例: bodi/arb/o
bog^i	# PEJVO例: bog^i/o
bohemi	# PEJVO例: bohemi/an/o
boleto	# PEJVO例: boleto
bols^evism	# PEJVO例: bols^evism/o
bols^evist	# PEJVO例: bols^evist/o
bos^man	# PEJVO例: bos^man/o
bosni	# PEJVO例: bosni/an/o
boson	# PEJVO例: boson/o
boston	# PEJVO例: boston/o
botau^r	# PEJVO例: botau^r/o
brag^	# PEJVO例: brag^/o
braman	# PEJVO例: braman/ism/o
branc^	# PEJVO例: branc^/aj^/o
branĉ	# PEJVO例: branĉ/a
brazil	# PEJVO例: brazil/a
brazilj	# PEJVO例: brazilj/a
brec^	# PEJVO例: brec^/et/i
brig^	# PEJVO例: brig^/i
briofit	# PEJVO例: briofit/oj
broc^	# PEJVO例: broc^/o
bromid	# PEJVO例: bromid/o
bronkit	# PEJVO例: bronkit/o
brontosaŭr	# PEJVO例: brontosaŭr/o
bros^ur	# PEJVO例: bros^ur/ad/o
broŝur	# PEJVO例: broŝur/il/o
brusel	# PEJVO例: brusel/brasik/o
buc^	# PEJVO例: buc^/ad/o
buda	# PEJVO例: buda/ism/o
budapes^t	# PEJVO例: budapes^t/a
budg^et	# PEJVO例: budg^et/o
budh	# PEJVO例: budh/an/a nom/o
bug^et	# PEJVO例: bug^et/a jar/o
bulbil	# PEJVO例: bulbil/o
burg^	# PEJVO例: burg^/a
burg^on	# PEJVO例: burg^on/brasik/o
burger	# PEJVO例: burger/o
burh^	# PEJVO例: burh^/o
burund	# PEJVO例: burund/an/o
burĝ	# PEJVO例: burĝ/iĝ/i
bus^	# PEJVO例: bus^/a
bus^el	# PEJVO例: bus^el/o
bus^men	# PEJVO例: bus^men/o
butan	# PEJVO例: butan/o
butanol	# PEJVO例: butanol/o
buĉ	# PEJVO例: buĉ/aĵ/o
buŝ	# PEJVO例: buŝ/aĉ/o
bv.	# PEJVO例: bv.
c^.	# PEJVO例: c^.
c^abrak	# PEJVO例: c^abrak/o
c^ador	# PEJVO例: c^ador/o
c^agren	# PEJVO例: c^agren/a
c^ajot	# PEJVO例: c^ajot/o
c^ak	# PEJVO例: c^ak/o
c^am	# PEJVO例: c^am/kolor/a
c^ambelan	# PEJVO例: c^ambelan/in/o
c^ambr	# PEJVO例: c^ambr/a orkestr/o
c^ampan	# PEJVO例: c^ampan/glas/o
c^ampion	# PEJVO例: c^ampion/ad/o
c^an	# PEJVO例: c^an/o
c^antag^	# PEJVO例: c^antag^/i
c^ap	# PEJVO例: c^ap/o
c^apel	# PEJVO例: c^apel/ej/o
c^apitr	# PEJVO例: c^apitr/o
c^ar	# PEJVO例: c^ar
c^arlatan	# PEJVO例: c^arlatan/aj^/o
c^arm	# PEJVO例: c^arm/a
c^arnir	# PEJVO例: c^arnir/o
c^arpent	# PEJVO例: c^arpent/ad/o
c^arpi	# PEJVO例: c^arpi/o
c^art	# PEJVO例: c^art/aviad/il/o
c^as	# PEJVO例: c^as/ad/o
c^asi	# PEJVO例: c^asi/o
c^ast	# PEJVO例: c^ast/a
c^e	# PEJVO例: c^e
c^ec^en	# PEJVO例: c^ec^en/o
c^ef	# PEJVO例: c^ef/a
c^ef-	# PEJVO例: c^ef-
c^eh^	# PEJVO例: c^eh^/a
c^ek	# PEJVO例: c^ek/o
c^el	# PEJVO例: c^el/aj^/o
c^elkerno	# PEJVO例: c^elkerno
c^emiz	# PEJVO例: c^emiz/bluz/o
c^en	# PEJVO例: c^en/a
c^eriz	# PEJVO例: c^eriz/arb/o
c^erk	# PEJVO例: c^erk/a
c^erkes	# PEJVO例: c^erkes/o
c^ernobil	# PEJVO例: c^ernobil/a nukle/a central/o
c^erp	# PEJVO例: c^erp/ad/o
c^es	# PEJVO例: c^es/i
c^eval	# PEJVO例: c^eval/ac^/o
c^evron	# PEJVO例: c^evron/o
c^i	# PEJVO例: c^i
c^i c^io	# PEJVO例: c^i c^io
c^i last	# PEJVO例: c^i last/a
c^i tia	# PEJVO例: c^i tia
c^i tial	# PEJVO例: c^i tial
c^i tiam	# PEJVO例: c^i tiam
c^i tie	# PEJVO例: c^i tie
c^i tiel	# PEJVO例: c^i tiel
c^i ties	# PEJVO例: c^i ties
c^i tio	# PEJVO例: c^i tio
c^i tiom	# PEJVO例: c^i tiom
c^i tiu	# PEJVO例: c^i tiu
c^i tiu last	# PEJVO例: c^i tiu last/a
c^i tiu semajn	# PEJVO例: c^i tiu semajn/o
c^i-flank	# PEJVO例: c^i-flank/e
c^i-foj	# PEJVO例: c^i-foj/e
c^i-jar	# PEJVO例: c^i-jar/a
c^i-kun	# PEJVO例: c^i-kun/e
c^i-land	# PEJVO例: c^i-land/a
c^i-maten	# PEJVO例: c^i-maten/e
c^i-moment	# PEJVO例: c^i-moment/e
c^i-nokt	# PEJVO例: c^i-nokt/e
c^i-okaz	# PEJVO例: c^i-okaz/e
c^i-pri	# PEJVO例: c^i-pri/e
c^i-rilat	# PEJVO例: c^i-rilat/e
c^i-semajn	# PEJVO例: c^i-semajn/e
c^i-sub	# PEJVO例: c^i-sub/e
c^i-supr	# PEJVO例: c^i-supr/e
c^i-tie	# PEJVO例: c^i-tie/a
c^i-vesper	# PEJVO例: c^i-vesper/e
c^ia	# PEJVO例: c^ia
c^ial	# PEJVO例: c^ial
c^iam	# PEJVO例: c^iam
c^iam pli	# PEJVO例: c^iam pli
c^ic^eron	# PEJVO例: c^ic^eron/o
c^ie	# PEJVO例: c^ie
c^ie ajn	# PEJVO例: c^ie ajn
c^iel	# PEJVO例: c^iel
c^ies	# PEJVO例: c^ies
c^if	# PEJVO例: c^if/aj^/o
c^ifon	# PEJVO例: c^ifon/a
c^ifr	# PEJVO例: c^ifr/a
c^ikan	# PEJVO例: c^ikan/em/a
c^il	# PEJVO例: c^il/o
c^ili	# PEJVO例: c^ili/an/o
c^im	# PEJVO例: c^im/o
c^imaron	# PEJVO例: c^imaron/o
c^impanz	# PEJVO例: c^impanz/o
c^in	# PEJVO例: c^in/a
c^io	# PEJVO例: c^io
c^io c^i	# PEJVO例: c^io c^i
c^iom	# PEJVO例: c^iom
c^ip	# PEJVO例: c^ip/a
c^ips	# PEJVO例: c^ips/oj
c^irkau^	# PEJVO例: c^irkau^
c^irp	# PEJVO例: c^irp/i
c^iu	# PEJVO例: c^iu
c^iz	# PEJVO例: c^iz/i
c^o	# PEJVO例: c^o
c^okolad	# PEJVO例: c^okolad/a
c^ot	# PEJVO例: c^ot/o
c^u	# PEJVO例: c^u
c^ukc^	# PEJVO例: c^ukc^/a
c^urask	# PEJVO例: c^urask/o
c^uvas^	# PEJVO例: c^uvas^/a lingv/o
cefal	# PEJVO例: cefal/a indic/o
cefe	# PEJVO例: cefe/id/o
cekumit	# PEJVO例: cekumit/o
celenter	# PEJVO例: celenter/ul/oj
celoidin	# PEJVO例: celoidin/o
celsi	# PEJVO例: celsi/a
celsius	# PEJVO例: celsius/a
celt	# PEJVO例: celt/o
celulit	# PEJVO例: celulit/o
cens	# PEJVO例: cens/o
cent mil	# PEJVO例: cent mil
centau^r	# PEJVO例: centau^r/o
centau^re	# PEJVO例: centau^re/o
centi-	# PEJVO例: centi-
centiar	# PEJVO例: centiar/o
centigram	# PEJVO例: centigram/o
centilitr	# PEJVO例: centilitr/o
centraliz	# PEJVO例: centraliz/i
cerber	# PEJVO例: cerber/o
cerumen	# PEJVO例: cerumen/o
cezar	# PEJVO例: cezar/a operaci/o
cianid	# PEJVO例: cianid/o
ciberspac	# PEJVO例: ciberspac/o
cikaded	# PEJVO例: cikaded/oj
cikloid	# PEJVO例: cikloid/o
ciklop	# PEJVO例: ciklop/a
cimbr	# PEJVO例: cimbr/oj
cion	# PEJVO例: cion/ism/o
cirkonferenc	# PEJVO例: cirkonferenc/o
co	# PEJVO例: co
cucugamuŝi	# PEJVO例: cucugamuŝi/o
cukcukcikad	# PEJVO例: cukcukcikad/o
d-ro	# PEJVO例: d-ro
dac	# PEJVO例: dac/o
damag^	# PEJVO例: damag^/i
damask	# PEJVO例: damask/o
dancig	# PEJVO例: dancig/i
dang^er	# PEJVO例: dang^er/a
dank' al	# PEJVO例: dank' al
darvin	# PEJVO例: darvin/ism/o
dau^b	# PEJVO例: dau^b/lign/o
dau^r	# PEJVO例: dau^r/a
daŭ	# PEJVO例: daŭ/o
daŭr	# PEJVO例: daŭr/ad/o
de antau^	# PEJVO例: de antau^
de kiam	# PEJVO例: de kiam
de mal	# PEJVO例: de mal/proksim/e
de nun	# PEJVO例: de nun
de post	# PEJVO例: de post
de proksim	# PEJVO例: de proksim/e
de sub	# PEJVO例: de sub
de sur	# PEJVO例: de sur
dec^ifr	# PEJVO例: dec^ifr/ad/o
deci-	# PEJVO例: deci-
decibel	# PEJVO例: decibel/o
decigram	# PEJVO例: decigram/o
decilitr	# PEJVO例: decilitr/o
decimetr	# PEJVO例: decimetr/o
dedic^	# PEJVO例: dedic^/i
defau^lt	# PEJVO例: defau^lt/o
dehidraci	# PEJVO例: dehidraci/o
deism	# PEJVO例: deism/o
deist	# PEJVO例: deist/o
dej^or	# PEJVO例: dej^or/a ministr/o
dek du	# PEJVO例: dek du
dek kvar	# PEJVO例: dek kvar
dek kvin	# PEJVO例: dek kvin
dek mil	# PEJVO例: dek mil
dek ses	# PEJVO例: dek ses
dek tri	# PEJVO例: dek tri
dek-du	# PEJVO例: dek-du/a
dek-kvar	# PEJVO例: dek-kvar/a
dek-kvin	# PEJVO例: dek-kvin/a
dek-ses	# PEJVO例: dek-ses/a
dek-tri	# PEJVO例: dek-tri/a
deka-	# PEJVO例: deka-
dekad	# PEJVO例: dekad/o
dekagram	# PEJVO例: dekagram/o
dekalitr	# PEJVO例: dekalitr/o
dekametr	# PEJVO例: dekametr/o
delft	# PEJVO例: delft/aj^/o
demars^	# PEJVO例: demars^/o
demograf	# PEJVO例: demograf/o
demoraliz	# PEJVO例: demoraliz/a
denominaci	# PEJVO例: denominaci/o
densometr	# PEJVO例: densometr/o
depes^	# PEJVO例: depes^/i
depresi	# PEJVO例: depresi/o
dermatit	# PEJVO例: dermatit/o
dermatolog	# PEJVO例: dermatolog/o
dermatologi	# PEJVO例: dermatologi/o
dermatoz	# PEJVO例: dermatoz/o
dervis^	# PEJVO例: dervis^/o
des mal	# PEJVO例: des mal/pli
des pli	# PEJVO例: des pli
detektor	# PEJVO例: detektor/o
detonaci	# PEJVO例: detonaci/i
deu^teri	# PEJVO例: deu^teri/o
deu^teron	# PEJVO例: deu^teron/o
devon	# PEJVO例: devon/o
devoni	# PEJVO例: devoni/o
dialektolog	# PEJVO例: dialektolog/o
dialektologi	# PEJVO例: dialektologi/o
diartr	# PEJVO例: diartr/o
dias	# PEJVO例: dias/o
diaskop	# PEJVO例: diaskop/o
diaterm	# PEJVO例: diaterm/a
diboc^	# PEJVO例: diboc^/a
diboĉ	# PEJVO例: diboĉ/aĵ/oj
difterit	# PEJVO例: difterit/o
diliĝenc	# PEJVO例: diliĝenc/o
diluvi	# PEJVO例: diluvi/o
dimanc^	# PEJVO例: dimanc^/a
dinamotor	# PEJVO例: dinamotor/o
dinosau^r	# PEJVO例: dinosau^r/o
dipleks	# PEJVO例: dipleks/a
dipol	# PEJVO例: dipol/o
direkci	# PEJVO例: direkci/o
direktal	# PEJVO例: direktal/o
direktori	# PEJVO例: direktori/o
dirigent	# PEJVO例: dirigent/o
dirt	# PEJVO例: dirt/a
dis-	# PEJVO例: dis-
disc^ipl	# PEJVO例: disc^ipl/o
disident	# PEJVO例: disident/o
diskursiv	# PEJVO例: diskursiv/a
divalent	# PEJVO例: divalent/a
diverg^	# PEJVO例: diverg^/a
diverg^enc	# PEJVO例: diverg^enc/o
diverĝ	# PEJVO例: diverĝ/ig/o
divizor	# PEJVO例: divizor/i
diĝit	# PEJVO例: diĝit/a
dog^	# PEJVO例: dog^/o
dolc^	# PEJVO例: dolc^/a
dolc^amar	# PEJVO例: dolc^amar/o
domag^	# PEJVO例: domag^/a
dominikan	# PEJVO例: dominikan/o
dong	# PEJVO例: dong/o
donj^uan	# PEJVO例: donj^uan/ism/o
donkih^ot	# PEJVO例: donkih^ot/ism/o
dop	# PEJVO例: dop/ad/o
dori	# PEJVO例: dori/an/o
dozologi	# PEJVO例: dozologi/o
dozometr	# PEJVO例: dozometr/o
dramaturg	# PEJVO例: dramaturg/o
dras^	# PEJVO例: dras^/ad/o
dravid	# PEJVO例: dravid/o
draĥm	# PEJVO例: draĥm/o
draĵ	# PEJVO例: draĵ/i
drednau^t	# PEJVO例: drednau^t/o
drezin	# PEJVO例: drezin/o
dros^k	# PEJVO例: dros^k/o
druz	# PEJVO例: druz/o
du kotiledon	# PEJVO例: du kotiledon/oj
du mil	# PEJVO例: du mil
duktil	# PEJVO例: duktil/a
duodenit	# PEJVO例: duodenit/o
duon	# PEJVO例: duon/sek/a
durdisk	# PEJVO例: durdisk/o
dus^	# PEJVO例: dus^/ej/o
dut	# PEJVO例: dut/o
e-ist	# PEJVO例: e-ist/a
e-libr	# PEJVO例: e-libr/o
e-vort	# PEJVO例: e-vort/o
ebol	# PEJVO例: ebol/a hemoragi/a febr/o
ec^	# PEJVO例: ec^
ec^ se	# PEJVO例: ec^ se
edinol	# PEJVO例: edinol/o
efervesk	# PEJVO例: efervesk/a
efloresk	# PEJVO例: efloresk/a
eg^	# PEJVO例: eg^/o
eh^	# PEJVO例: eh^/e
ejakul	# PEJVO例: ejakul/i
ek-	# PEJVO例: ek-
ekau^dat	# PEJVO例: ekau^dat/oj
ekinokl	# PEJVO例: ekinokl/o
eko	# PEJVO例: eko/impost/o
eko-	# PEJVO例: eko-
eks-	# PEJVO例: eks-
ekscelenc	# PEJVO例: ekscelenc/o
ekscitator	# PEJVO例: ekscitator/o
ekskoriaci	# PEJVO例: ekskoriaci/o
eksponometr	# PEJVO例: eksponometr/o
eksport-import	# PEJVO例: eksport-import/a
ekspoz	# PEJVO例: ekspoz/i
ekspresionism	# PEJVO例: ekspresionism/o
ekstemporal	# PEJVO例: ekstemporal/e
ekvatorial	# PEJVO例: ekvatorial/o
ekvil	# PEJVO例: ekvil/o
ekz.	# PEJVO例: ekz.
ekzekv	# PEJVO例: ekzekv/i
ekzistencialist	# PEJVO例: ekzistencialist/o
ekzorciz	# PEJVO例: ekzorciz/i
ekzot	# PEJVO例: ekzot/a
ekzoterm	# PEJVO例: ekzoterm/a
el inter	# PEJVO例: el inter
el sub	# PEJVO例: el sub
el-	# PEJVO例: el-
elatr	# PEJVO例: elatr/o
eldon	# PEJVO例: eldon/fak/o
elipsoid	# PEJVO例: elipsoid/o
elize	# PEJVO例: elize/a
embol	# PEJVO例: embol/o
emboloz	# PEJVO例: emboloz/o
embriogenez	# PEJVO例: embriogenez/o
embriogeni	# PEJVO例: embriogeni/o
embriolog	# PEJVO例: embriolog/o
emerg^	# PEJVO例: emerg^/a angul/o
emerĝ	# PEJVO例: emerĝ/a
eminenc	# PEJVO例: eminenc/o
empenal	# PEJVO例: empenal/o
empirism	# PEJVO例: empirism/o
empirist	# PEJVO例: empirist/o
en-	# PEJVO例: en-
en- kaj ekster-land	# PEJVO例: en- kaj ekster-land/e
enad	# PEJVO例: enad/o
enantem	# PEJVO例: enantem/o
encefalit	# PEJVO例: encefalit/o
encefalopati	# PEJVO例: encefalopati/o
endo	# PEJVO例: endo/skop/o
endokard	# PEJVO例: endokard/o
endokardit	# PEJVO例: endokardit/o
endometrit	# PEJVO例: endometrit/o
endos	# PEJVO例: endos/i
energetik	# PEJVO例: energetik/o
engag^	# PEJVO例: engag^/i
engl	# PEJVO例: engl/o
engrau^l	# PEJVO例: engrau^l/o
enorm	# PEJVO例: enorm/a
entalpi	# PEJVO例: entalpi/o
entozo	# PEJVO例: entozo/o
eparh^i	# PEJVO例: eparh^i/o
ependim	# PEJVO例: ependim/o
ependimit	# PEJVO例: ependimit/o
epidemiologi	# PEJVO例: epidemiologi/a esplor/o
epifor	# PEJVO例: epifor/o
epigin	# PEJVO例: epigin/a
epikur	# PEJVO例: epikur/a
erbin	# PEJVO例: erbin/o
ergograf	# PEJVO例: ergograf/o
ergologi	# PEJVO例: ergologi/o
ergometr	# PEJVO例: ergometr/o
eriobotri	# PEJVO例: eriobotri/o
eritrocit	# PEJVO例: eritrocit/o
eritrozin	# PEJVO例: eritrozin/o
es^afod	# PEJVO例: es^afod/o
eskadron	# PEJVO例: eskadron/o
eskalator	# PEJVO例: eskalator/o
esp-ist	# PEJVO例: esp-ist/o
esp.	# PEJVO例: esp.
esperantolog	# PEJVO例: esperantolog/o
esperantologi	# PEJVO例: esperantologi/a
estragon	# PEJVO例: estragon/o
etag^	# PEJVO例: etag^/ig/i
etag^er	# PEJVO例: etag^er/o
etanol	# PEJVO例: etanol/o
etilen	# PEJVO例: etilen/o
etnograf	# PEJVO例: etnograf/o
etnografi	# PEJVO例: etnografi/o
etnolog	# PEJVO例: etnolog/o
etnologi	# PEJVO例: etnologi/o
eu^diometr	# PEJVO例: eu^diometr/o
eu^diometri	# PEJVO例: eu^diometri/o
eu^femism	# PEJVO例: eu^femism/a
eu^forbi	# PEJVO例: eu^forbi/o
eu^forbiac	# PEJVO例: eu^forbiac/oj
eu^genik	# PEJVO例: eu^genik/o
eu^kalipt	# PEJVO例: eu^kalipt/o
eu^karisti	# PEJVO例: eu^karisti/o
eu^klid	# PEJVO例: eu^klid/a geometri/o
eu^nuk	# PEJVO例: eu^nuk/o
eu^r	# PEJVO例: eu^r/o
eu^rop	# PEJVO例: eu^rop/a
eu^roparlament	# PEJVO例: eu^roparlament/an/o
eu^ropi	# PEJVO例: eu^ropi/o
eu^sk	# PEJVO例: eu^sk/a lingv/o
eu^tanazi	# PEJVO例: eu^tanazi/i
eu^trof	# PEJVO例: eu^trof/a
ezofagit	# PEJVO例: ezofagit/o
eĥ	# PEJVO例: eĥ/il/o
eĥidn	# PEJVO例: eĥidn/o
eĥin	# PEJVO例: eĥin/o
eĥinoderm	# PEJVO例: eĥinoderm/oj
eŭfori	# PEJVO例: eŭfori/a
eŭfrazi	# PEJVO例: eŭfrazi/o
eŭgenik	# PEJVO例: eŭgenik/ism/o
eŭkaristi	# PEJVO例: eŭkaristi/a
eŭpatori	# PEJVO例: eŭpatori/o
eŭsk	# PEJVO例: eŭsk/a
eŭtanazi	# PEJVO例: eŭtanazi/a
fabac	# PEJVO例: fabac/oj
facet	# PEJVO例: facet/i
fagocitoz	# PEJVO例: fagocitoz/o
fakoc^er	# PEJVO例: fakoc^er/o
faktori	# PEJVO例: faktori/o
falc^	# PEJVO例: falc^/ad/o
falĉ	# PEJVO例: falĉ/aĵ/o
fan	# PEJVO例: fan/o
farbit	# PEJVO例: farbit/o
farc^	# PEJVO例: farc^/i
farenhejt	# PEJVO例: farenhejt/a
faringit	# PEJVO例: faringit/o
fas^ism	# PEJVO例: fas^ism/o
fas^ist	# PEJVO例: fas^ist/o
fasc^in	# PEJVO例: fasc^in/i
fatsi	# PEJVO例: fatsi/o
fau^k	# PEJVO例: fau^k/i
fau^l	# PEJVO例: fau^l/i
fau^n	# PEJVO例: fau^n/o
fec^	# PEJVO例: fec^/o
federal	# PEJVO例: federal/a
felandri	# PEJVO例: felandri/o
felic^	# PEJVO例: felic^/a
felised	# PEJVO例: felised/oj
feliĉ	# PEJVO例: feliĉ/eg/a
feloid	# PEJVO例: feloid/oj
femural	# PEJVO例: femural/o
fenomenologi	# PEJVO例: fenomenologi/o
ferik	# PEJVO例: ferik/a
fermion	# PEJVO例: fermion/o
feromagnet	# PEJVO例: feromagnet/a
feromon	# PEJVO例: feromon/o
ferotipi	# PEJVO例: ferotipi/o
feroz	# PEJVO例: feroz/a
fetic^	# PEJVO例: fetic^/ism/o
fetiĉ	# PEJVO例: fetiĉ/ist/o
feu^d	# PEJVO例: feu^d/a
feĉ	# PEJVO例: feĉ/a
feŭd	# PEJVO例: feŭd/ec/o
fi-	# PEJVO例: fi-
fianc^	# PEJVO例: fianc^/amik/o
fianĉ	# PEJVO例: fianĉ/a
fiktiv	# PEJVO例: fiktiv/a
filateli	# PEJVO例: filateli/o
filipin	# PEJVO例: filipin/an/o
filis^t	# PEJVO例: filis^t/o
fimbril	# PEJVO例: fimbril/o
firmvar	# PEJVO例: firmvar/o
fis^	# PEJVO例: fis^/ad/o
fisi	# PEJVO例: fisi/o
fiteŭm	# PEJVO例: fiteŭm/o
fitogeografi	# PEJVO例: fitogeografi/o
fitoterapi	# PEJVO例: fitoterapi/o
fiziografi	# PEJVO例: fiziografi/o
fiŝ	# PEJVO例: fiŝ/a
flag^olet	# PEJVO例: flag^olet/o
flakurti	# PEJVO例: flakurti/o
flang^	# PEJVO例: flang^/o
flau^n	# PEJVO例: flau^n/o
flau^r	# PEJVO例: flau^r/o
fluorid	# PEJVO例: fluorid/o
fluorit	# PEJVO例: fluorit/o
fo	# PEJVO例: fo
foladed	# PEJVO例: foladed/oj
fono	# PEJVO例: fono/skop/o
fonogram	# PEJVO例: fonogram/o
fonon	# PEJVO例: fonon/o
for-	# PEJVO例: for-
forg^	# PEJVO例: forg^/ad/o
formalin	# PEJVO例: formalin/o
fornel	# PEJVO例: fornel/o
forĝ	# PEJVO例: forĝ/o
fosf	# PEJVO例: fosf/o
fosforit	# PEJVO例: fosforit/o
fotind	# PEJVO例: fotind/a s^anc/o
frac^j	# PEJVO例: frac^j/o
franciskan	# PEJVO例: franciskan/o
frang^	# PEJVO例: frang^/i
franj	# PEJVO例: franj/o
franĝ	# PEJVO例: franĝ/ig/i
frau^d	# PEJVO例: frau^d/a bankrot/o
frau^l	# PEJVO例: frau^l/ec/o
fraŭd	# PEJVO例: fraŭd/iĝ/o
fraŭl	# PEJVO例: fraŭl/a
frekvencometr	# PEJVO例: frekvencometr/o
frenolog	# PEJVO例: frenolog/o
freon	# PEJVO例: freon/o
fres^	# PEJVO例: fres^/a
freu^d	# PEJVO例: freu^d/a
freŝ	# PEJVO例: freŝ/e
fromag^	# PEJVO例: fromag^/klos^/o
fromaĝ	# PEJVO例: fromaĝ/ej/o
fruntal	# PEJVO例: fruntal/o
ftizolog	# PEJVO例: ftizolog/o
ftizologi	# PEJVO例: ftizologi/o
fug^	# PEJVO例: fug^/i
fulmin	# PEJVO例: fulmin/i
fungus	# PEJVO例: fungus/o
furag^	# PEJVO例: furag^/i
fus^	# PEJVO例: fus^/a
fuzelag^	# PEJVO例: fuzelag^/o
fuzi	# PEJVO例: fuzi/o
fuĝ	# PEJVO例: fuĝ/ig/i
g^angal	# PEJVO例: g^angal/o
g^arden	# PEJVO例: g^arden/a
g^azband	# PEJVO例: g^azband/o
g^el	# PEJVO例: g^el/o
g^em	# PEJVO例: g^em/i
g^emel	# PEJVO例: g^emel/a
g^en	# PEJVO例: g^en/a
g^endarm	# PEJVO例: g^endarm/ar/o
g^eneral	# PEJVO例: g^eneral/a
g^enov	# PEJVO例: g^enov/an/ec/o
g^enr	# PEJVO例: g^enr/o
g^entil	# PEJVO例: g^entil/a
g^entleman	# PEJVO例: g^entleman/o
g^erm	# PEJVO例: g^erm/ad/o
g^erman	# PEJVO例: g^erman/a vo
g^et	# PEJVO例: g^et/kaj/o
g^i	# PEJVO例: g^i
g^ib	# PEJVO例: g^ib/a balen/o
g^ihad	# PEJVO例: g^ihad/o
g^in	# PEJVO例: g^in/o
g^inz	# PEJVO例: g^inz/o
g^ir	# PEJVO例: g^ir/ad/o
g^iraf	# PEJVO例: g^iraf/o
g^is	# PEJVO例: g^is
g^is kiam	# PEJVO例: g^is kiam
g^is nun	# PEJVO例: g^is nun
g^is-	# PEJVO例: g^is-
g^o	# PEJVO例: g^o
g^oj	# PEJVO例: g^oj/a
g^u	# PEJVO例: g^u/ad/o
g^ust	# PEJVO例: g^ust/a
gajakol	# PEJVO例: gajakol/o
gajlat	# PEJVO例: gajlat/a acid/o
galantin	# PEJVO例: galantin/o
galicism	# PEJVO例: galicism/o
galinul	# PEJVO例: galinul/o
galos^	# PEJVO例: galos^/o
galvaniz	# PEJVO例: galvaniz/i
gama	# PEJVO例: gama
gama-dis	# PEJVO例: gama-dis/er/ig^/o
gamas^	# PEJVO例: gamas^/o
gang	# PEJVO例: gang/o
garag^	# PEJVO例: garag^/i
gasometr	# PEJVO例: gasometr/o
gau^c^	# PEJVO例: gau^c^/o
gau^g^	# PEJVO例: gau^g^/i
gau^l	# PEJVO例: gau^l/o
gau^lt	# PEJVO例: gau^lt/o
gau^s	# PEJVO例: gau^s/o
gavi	# PEJVO例: gavi/o
gaŭlteri	# PEJVO例: gaŭlteri/o
gaŭr	# PEJVO例: gaŭr/o
ge-	# PEJVO例: ge-
gejs^	# PEJVO例: gejs^/o
gejŝ	# PEJVO例: gejŝ/ej/o
geloz	# PEJVO例: geloz/o
general-	# PEJVO例: general-/leu^tenant/o
generator	# PEJVO例: generator/o
genom	# PEJVO例: genom/o
geometred	# PEJVO例: geometred/oj
georgin	# PEJVO例: georgin/o
gett	# PEJVO例: gett/o
gic^et	# PEJVO例: gic^et/o
giga	# PEJVO例: giga/elektr/on/volt/o
giga-	# PEJVO例: giga-
gigabajt	# PEJVO例: gigabajt/o
gigaherc	# PEJVO例: gigaherc/o
gigavat	# PEJVO例: gigavat/o
gilbert	# PEJVO例: gilbert/o
gilos^	# PEJVO例: gilos^/ad/o
gine	# PEJVO例: gine/o
gingivit	# PEJVO例: gingivit/o
gink	# PEJVO例: gink/o
ginostem	# PEJVO例: ginostem/o
giro	# PEJVO例: giro/skop/a kompas/o
glau^ci	# PEJVO例: glau^ci/o
glau^konit	# PEJVO例: glau^konit/o
glaĉer	# PEJVO例: glaĉer/o
glaŭkom	# PEJVO例: glaŭkom/o
gld.	# PEJVO例: gld.
glicerid	# PEJVO例: glicerid/o
gliceril	# PEJVO例: gliceril/o
glicerol	# PEJVO例: glicerol/o
globul	# PEJVO例: globul/o
go	# PEJVO例: go
gobang	# PEJVO例: gobang/o
gorg^	# PEJVO例: gorg^/a
gorĝ	# PEJVO例: gorĝ/et/o
grafen	# PEJVO例: grafen/o
grafiti	# PEJVO例: grafiti/o
grafospasm	# PEJVO例: grafospasm/o
graj	# PEJVO例: graj/o
grajp	# PEJVO例: grajp/o
gramenac	# PEJVO例: gramenac/oj
gramine	# PEJVO例: gramine/oj
granol	# PEJVO例: granol/o
gratif	# PEJVO例: gratif/i
gratifikaci	# PEJVO例: gratifikaci/o
gros^	# PEJVO例: gros^/o
groŝ	# PEJVO例: groŝ/a
guas^	# PEJVO例: guas^/o
guaŝ	# PEJVO例: guaŝ/i
gulag	# PEJVO例: gulag/o
gulas^	# PEJVO例: gulas^/o
gurk	# PEJVO例: gurk/o
gus^	# PEJVO例: gus^/o
gvajakol	# PEJVO例: gvajakol/o
gval	# PEJVO例: gval/o
gvine	# PEJVO例: gvine/an/o
h^alde	# PEJVO例: h^alde/o
h^ameleon	# PEJVO例: h^ameleon/o
h^an	# PEJVO例: h^an/o
h^aos	# PEJVO例: h^aos/a
h^emi	# PEJVO例: h^emi/o
h^etid	# PEJVO例: h^etid/oj
h^imer	# PEJVO例: h^imer/a
h^in	# PEJVO例: h^in/o
h^irurg	# PEJVO例: h^irurg/o
h^irurgi	# PEJVO例: h^irurgi/o
h^mer	# PEJVO例: h^mer/o
h^o	# PEJVO例: h^o
h^oler	# PEJVO例: h^oler/o
h^or	# PEJVO例: h^or/aj^/o
h^ore	# PEJVO例: h^ore/o
ha ha ha	# PEJVO例: ha ha ha
habitat	# PEJVO例: habitat/o
habsburg	# PEJVO例: habsburg/a
hadron	# PEJVO例: hadron/o
hag^	# PEJVO例: hag^/o
half	# PEJVO例: half/o
haliĥer	# PEJVO例: haliĥer/o
halogenid	# PEJVO例: halogenid/o
haloo	# PEJVO例: haloo
halucinaci	# PEJVO例: halucinaci/o
hamburger	# PEJVO例: hamburger/o
han	# PEJVO例: han/o
hangul	# PEJVO例: hangul/o
hanifit	# PEJVO例: hanifit/a skol/o
hardvar	# PEJVO例: hardvar/o
harpal	# PEJVO例: harpal/o
harpaled	# PEJVO例: harpaled/oj
has^is^	# PEJVO例: has^is^/ism/o
hau^biz	# PEJVO例: hau^biz/o
hau^l	# PEJVO例: hau^l/i
hau^t	# PEJVO例: hau^t/eg/o
havaj	# PEJVO例: havaj/a
haĉ	# PEJVO例: haĉ/ad/o
haŭt	# PEJVO例: haŭt/a
he ho	# PEJVO例: he ho
heg^	# PEJVO例: heg^/o
heg^ir	# PEJVO例: heg^ir/o
hegel	# PEJVO例: hegel/ism/o
heksaedr	# PEJVO例: heksaedr/o
hektar	# PEJVO例: hektar/o
hekto-	# PEJVO例: hekto-
hektogram	# PEJVO例: hektogram/o
hektolitr	# PEJVO例: hektolitr/o
hektometr	# PEJVO例: hektometr/o
hektopaskal	# PEJVO例: hektopaskal/o
hemerokalid	# PEJVO例: hemerokalid/o
henr	# PEJVO例: henr/o
hepatikopsid	# PEJVO例: hepatikopsid/oj
hepatit	# PEJVO例: hepatit/o
hermet	# PEJVO例: hermet/a
hermini	# PEJVO例: hermini/o
hes	# PEJVO例: hes/o
hidrange	# PEJVO例: hidrange/o
hidrau^lik	# PEJVO例: hidrau^lik/a
hidroaeroplan	# PEJVO例: hidroaeroplan/o
hidrodinamik	# PEJVO例: hidrodinamik/o
hidroelektr	# PEJVO例: hidroelektr/a
hidrofobi	# PEJVO例: hidrofobi/o
hidrokarbid	# PEJVO例: hidrokarbid/o
hidrokarbon	# PEJVO例: hidrokarbon/o
hidroksid	# PEJVO例: hidroksid/o
hidrometr	# PEJVO例: hidrometr/o
hidrometri	# PEJVO例: hidrometri/o
hidrostatik	# PEJVO例: hidrostatik/a prem/o
hidroterapi	# PEJVO例: hidroterapi/o
hierarh^i	# PEJVO例: hierarh^i/o
hierau^	# PEJVO例: hierau^
hierau^ nokt	# PEJVO例: hierau^ nokt/e
hierau^ vesper	# PEJVO例: hierau^ vesper/e
hig^ab	# PEJVO例: hig^ab/o
higr	# PEJVO例: higr/o/metr/o
hilel	# PEJVO例: hilel/ism/o
himalaj	# PEJVO例: himalaj/a cedr/o
hinajan	# PEJVO例: hinajan/o
hindi	# PEJVO例: hindi/a
hindoc^in	# PEJVO例: hindoc^in/a
hiperboloid	# PEJVO例: hiperboloid/o
hiperemi	# PEJVO例: hiperemi/o
hiperonim	# PEJVO例: hiperonim/o
hipocikloid	# PEJVO例: hipocikloid/o
hipoh^ondri	# PEJVO例: hipoh^ondri/o
hipokas^tan	# PEJVO例: hipokas^tan/o
hiponim	# PEJVO例: hiponim/o
hipotensi	# PEJVO例: hipotensi/o
hipsipet	# PEJVO例: hipsipet/o
hipsometr	# PEJVO例: hipsometr/o
hipsometri	# PEJVO例: hipsometri/o
hitit	# PEJVO例: hitit/o
hitler	# PEJVO例: hitler/ism/o
hiziki	# PEJVO例: hiziki/o
ho ve	# PEJVO例: ho ve
hobit	# PEJVO例: hobit/o
hodiau^	# PEJVO例: hodiau^
hodiau^ maten	# PEJVO例: hodiau^ maten/e
hodiau^ vesper	# PEJVO例: hodiau^ vesper/e
hoj!	# PEJVO例: hoj!
hologram	# PEJVO例: hologram/o
holokau^st	# PEJVO例: holokau^st/o
homeogril	# PEJVO例: homeogril/o
horlog^	# PEJVO例: horlog^/bracelet/o
horloĝ	# PEJVO例: horloĝ/a
hot!	# PEJVO例: hot!
hoto!	# PEJVO例: hoto!
hotujni	# PEJVO例: hotujni/o
hungr	# PEJVO例: hungr/i
husum	# PEJVO例: husum/o
i-vort	# PEJVO例: i-vort/o
i.a.	# PEJVO例: i.a.
iam ajn	# PEJVO例: iam ajn
iam kaj iam	# PEJVO例: iam kaj iam
ic	# PEJVO例: ic/o
ideogram	# PEJVO例: ideogram/o
ideolog	# PEJVO例: ideolog/o
ig^	# PEJVO例: ig^/i
ih^tiokol	# PEJVO例: ih^tiokol/o
ih^tiosau^r	# PEJVO例: ih^tiosau^r/o
ikneŭmon	# PEJVO例: ikneŭmon/o
iktiosau^r	# PEJVO例: iktiosau^r/o
iktiosaŭr	# PEJVO例: iktiosaŭr/ul/oj
iliri	# PEJVO例: iliri/a
imagin	# PEJVO例: imagin/ig^/o
imperial	# PEJVO例: imperial/o
imperialism	# PEJVO例: imperialism/o
imperialist	# PEJVO例: imperialist/o
imperium	# PEJVO例: imperium/o
implod	# PEJVO例: implod/i
inau^gur	# PEJVO例: inau^gur/ad/o
inau^guraci	# PEJVO例: inau^guraci/o
inaŭgur	# PEJVO例: inaŭgur/a
indig^en	# PEJVO例: indig^en/a
indiga	# PEJVO例: indiga
indigo	# PEJVO例: indigo
indikator	# PEJVO例: indikator/o
individualism	# PEJVO例: individualism/o
individualist	# PEJVO例: individualist/o
indonezi	# PEJVO例: indonezi/a lingv/o
influenc	# PEJVO例: influenc/o
influk	# PEJVO例: influk/i
infrarug^	# PEJVO例: infrarug^/a
infrason	# PEJVO例: infrason/o
infrastruktur	# PEJVO例: infrastruktur/o
ing^eni	# PEJVO例: ing^eni/a
ing^enier	# PEJVO例: ing^enier/a
iniciator	# PEJVO例: iniciator/o
injektor	# PEJVO例: injektor/o
inka	# PEJVO例: inka/a
inkl.	# PEJVO例: inkl.
inocent	# PEJVO例: inocent/a
insekticid	# PEJVO例: insekticid/o
insolaci	# PEJVO例: insolaci/o
instep	# PEJVO例: instep/o
insurekci	# PEJVO例: insurekci/o
int.	# PEJVO例: int.
integral	# PEJVO例: integral/a
intensiv	# PEJVO例: intensiv/a
inter si	# PEJVO例: inter si
inter-	# PEJVO例: inter-
interferometr	# PEJVO例: interferometr/o
interferon	# PEJVO例: interferon/o
interlingvist	# PEJVO例: interlingvist/o
interlingvistik	# PEJVO例: interlingvistik/o
internau^t	# PEJVO例: internau^t/o
interval	# PEJVO例: interval/o
introvertit	# PEJVO例: introvertit/o
intu	# PEJVO例: intu/o
inuit	# PEJVO例: inuit/o
invari	# PEJVO例: invari/ant/o
inĝenier	# PEJVO例: inĝenier/ar/o
iom post iom	# PEJVO例: iom post iom
ionik	# PEJVO例: ionik/a kapitel/o
irak	# PEJVO例: irak/an/o
iran	# PEJVO例: iran/a
irland	# PEJVO例: irland/a
is-temp	# PEJVO例: is-temp/o
island	# PEJVO例: island/a
israel	# PEJVO例: israel/a
itiner	# PEJVO例: itiner/o
izentrop	# PEJVO例: izentrop/a
izodinam	# PEJVO例: izodinam/o
izokron	# PEJVO例: izokron/a
j^abot	# PEJVO例: j^abot/o
j^ak	# PEJVO例: j^ak/o
j^aket	# PEJVO例: j^aket/o
j^aluz	# PEJVO例: j^aluz/a
j^aluzi	# PEJVO例: j^aluzi/o
j^ambore	# PEJVO例: j^ambore/o
j^argon	# PEJVO例: j^argon/aj^/o
j^artel	# PEJVO例: j^artel/o
j^au^d	# PEJVO例: j^au^d/a
j^az	# PEJVO例: j^az/band/o
j^ele	# PEJVO例: j^ele/o
j^erz	# PEJVO例: j^erz/o
j^et	# PEJVO例: j^et/ad/o
j^eton	# PEJVO例: j^eton/o
j^ib	# PEJVO例: j^ib/o
j^ig	# PEJVO例: j^ig/o
j^ij^icikad	# PEJVO例: j^ij^icikad/o
j^inriks^	# PEJVO例: j^inriks^/o
j^ip	# PEJVO例: j^ip/o
j^o	# PEJVO例: j^o
j^oke	# PEJVO例: j^oke/o
j^ongl	# PEJVO例: j^ongl/ad/o
j^onk	# PEJVO例: j^onk/o
j^os	# PEJVO例: j^os/i
j^ud	# PEJVO例: j^ud/ej/estr/o
j^ul	# PEJVO例: j^ul/o
j^ur	# PEJVO例: j^ur/a
j^uras	# PEJVO例: j^uras/o
j^uri	# PEJVO例: j^uri/an/o
j^urnal	# PEJVO例: j^urnal/a dosier/o
j^us	# PEJVO例: j^us
jagi	# PEJVO例: jagi/a anten/o
jah^t	# PEJVO例: jah^t/o
jakut	# PEJVO例: jakut/o
jalap	# PEJVO例: jalap/o
jam de	# PEJVO例: jam de/long/e
janic^ar	# PEJVO例: janic^ar/o
jc	# PEJVO例: jc
je c^iu prez	# PEJVO例: je c^iu prez/o
jeti	# PEJVO例: jeti/o
jo	# PEJVO例: jo
jodid	# PEJVO例: jodid/o
jokan	# PEJVO例: jokan/o
jota	# PEJVO例: jota
ju mal	# PEJVO例: ju mal/pli
ju pli	# PEJVO例: ju pli
juan	# PEJVO例: juan/o
judaism	# PEJVO例: judaism/o
jug^	# PEJVO例: jug^/a
jugoslavi	# PEJVO例: jugoslavi/a
juĝ	# PEJVO例: juĝ/ad/i
k-do	# PEJVO例: k-do
k-et	# PEJVO例: k-et/o
k-o	# PEJVO例: k-o
k.a.	# PEJVO例: k.a.
k.c.	# PEJVO例: k.c.
k.s.	# PEJVO例: k.s.
k.t.p.	# PEJVO例: k.t.p.
kHz	# PEJVO例: kHz
kabaret	# PEJVO例: kabaret/o
kabil	# PEJVO例: kabil/o
kabuk	# PEJVO例: kabuk/o
kac^	# PEJVO例: kac^/ig/i
kac^alot	# PEJVO例: kac^alot/o
kag^	# PEJVO例: kag^/o
kaj ali	# PEJVO例: kaj ali/aj
kaj ceter	# PEJVO例: kaj ceter/aj
kaj simil	# PEJVO例: kaj simil/aj
kaj tiel plu	# PEJVO例: kaj tiel plu
kaj-sign	# PEJVO例: kaj-sign/o
kaj^ol	# PEJVO例: kaj^ol/a
kak	# PEJVO例: kak/i
kalandra	# PEJVO例: kalandra/o
kales^	# PEJVO例: kales^/aj^/o
kaleŝ	# PEJVO例: kaleŝ/aĵ/ist/o
kaliforni	# PEJVO例: kaliforni/o
kalikl	# PEJVO例: kalikl/a
kalorimetr	# PEJVO例: kalorimetr/o
kalorimetri	# PEJVO例: kalorimetri/o
kalvari	# PEJVO例: kalvari/a voj/o
kalvin	# PEJVO例: kalvin/an/o
kamabok	# PEJVO例: kamabok/o
kambog^	# PEJVO例: kambog^/an/o
kambri	# PEJVO例: kambri/o
kampanet	# PEJVO例: kampanet/o
kampec^	# PEJVO例: kampec^/o
kana	# PEJVO例: kana/o
kanaan	# PEJVO例: kanaan/id/o
kanacikad	# PEJVO例: kanacikad/o
kanad	# PEJVO例: kanad/a
kanak	# PEJVO例: kanak/o
kanal	# PEJVO例: kanal/et/o
kanaliz	# PEJVO例: kanaliz/i
kancional	# PEJVO例: kancional/o
kanistr	# PEJVO例: kanistr/o
kantil	# PEJVO例: kantil/o
kanton	# PEJVO例: kanton/o
kapitul	# PEJVO例: kapitul/o
kapuc^	# PEJVO例: kapuc^/i
kapuc^in	# PEJVO例: kapuc^in/o
karaoke	# PEJVO例: karaoke/o
karbonat	# PEJVO例: karbonat/a acid/o
karboni	# PEJVO例: karboni/o
karib	# PEJVO例: karib/a
kariofilac	# PEJVO例: kariofilac/oj
karit	# PEJVO例: karit/o
karmel	# PEJVO例: karmel/an/o
kartoc^	# PEJVO例: kartoc^/bend/o
kartus^	# PEJVO例: kartus^/o
kartuzi	# PEJVO例: kartuzi/an/a likvor/o
kas^	# PEJVO例: kas^/e
kas^tan	# PEJVO例: kas^tan/arb/o
kasket	# PEJVO例: kasket/o
kastili	# PEJVO例: kastili/a lingv/o
katalau^n	# PEJVO例: katalau^n/o
kateh^ism	# PEJVO例: kateh^ism/o
kateh^ist	# PEJVO例: kateh^ist/o
kateh^iz	# PEJVO例: kateh^iz/i
kateĉu	# PEJVO例: kateĉu/o
katgut	# PEJVO例: katgut/a kord/o
kau^c^uk	# PEJVO例: kau^c^uk/a
kau^ci	# PEJVO例: kau^ci/i
kau^r	# PEJVO例: kau^r/e
kau^stik	# PEJVO例: kau^stik/a
kau^ter	# PEJVO例: kau^ter/i
kau^teriz	# PEJVO例: kau^teriz/aj^/o
kau^z	# PEJVO例: kau^z/ec/o
kazah^	# PEJVO例: kazah^/o
kazuar	# PEJVO例: kazuar/o
kazuist	# PEJVO例: kazuist/o
kazuistik	# PEJVO例: kazuistik/o
kaĵol	# PEJVO例: kaĵol/ad/o
kaŝ	# PEJVO例: kaŝ/a
kaŝtan	# PEJVO例: kaŝtan/brun/a
kaŭstik	# PEJVO例: kaŭstik/o
kaŭter	# PEJVO例: kaŭter/ad/o
kaŭz	# PEJVO例: kaŭz/a
kebab	# PEJVO例: kebab/o
kec^u	# PEJVO例: kec^u/a lingv/o
kec^up	# PEJVO例: kec^up/o
kejns	# PEJVO例: kejns/ism/o
keloid	# PEJVO例: keloid/o
kelvin	# PEJVO例: kelvin/o
kenj	# PEJVO例: kenj/an/o
kenopodi	# PEJVO例: kenopodi/o
kenozoik	# PEJVO例: kenozoik/o
kermes	# PEJVO例: kermes/o
kiberspac	# PEJVO例: kiberspac/o
kic^	# PEJVO例: kic^/a
kidnap	# PEJVO例: kidnap/i
kiel antau^	# PEJVO例: kiel antau^/vid/it/e
kiel ebl	# PEJVO例: kiel ebl/e plej
kiel kutim	# PEJVO例: kiel kutim/e
kik	# PEJVO例: kik/i
kilo-	# PEJVO例: kilo-
kilobajt	# PEJVO例: kilobajt/o
kilobit	# PEJVO例: kilobit/o
kilocikl	# PEJVO例: kilocikl/o
kilogram	# PEJVO例: kilogram/fort/o
kiloherc	# PEJVO例: kiloherc/o
kilokalori	# PEJVO例: kilokalori/o
kilolitr	# PEJVO例: kilolitr/o
kilometr	# PEJVO例: kilometr/o
kiloom	# PEJVO例: kiloom/o
kilovat	# PEJVO例: kilovat/hor/o
kilovolt	# PEJVO例: kilovolt/o
kimc^i	# PEJVO例: kimc^i/o
kimer	# PEJVO例: kimer/o
kinetik	# PEJVO例: kinetik/o
kinu	# PEJVO例: kinu/o
kiril	# PEJVO例: kiril/a
kirlo	# PEJVO例: kirlo/frit/i
kirs^	# PEJVO例: kirs^/o
kiv	# PEJVO例: kiv/o
klac^	# PEJVO例: klac^/em/a
klak'	# PEJVO例: klak'
klau^n	# PEJVO例: klau^n/aj^/o
klau^str	# PEJVO例: klau^str/o
klau^z	# PEJVO例: klau^z/o
klaĉ	# PEJVO例: klaĉ/ist/in/o
klemat	# PEJVO例: klemat/o
klerikal	# PEJVO例: klerikal/a
klinometr	# PEJVO例: klinometr/o
klis^	# PEJVO例: klis^/aj^/o
klon	# PEJVO例: klon/ad/o
klos^	# PEJVO例: klos^/et/o
kluc^	# PEJVO例: kluc^/ad/o
knedlik	# PEJVO例: knedlik/o
knokau^t	# PEJVO例: knokau^t/i
ko	# PEJVO例: ko
koc^enil	# PEJVO例: koc^enil/o
koc^er	# PEJVO例: koc^er/o
koc^inc^in	# PEJVO例: koc^inc^in/o
kognat	# PEJVO例: kognat/o
kojlit	# PEJVO例: kojlit/o
kokakola	# PEJVO例: kokakola/o
koklus^	# PEJVO例: koklus^/o
kokotraŭst	# PEJVO例: kokotraŭst/o
koksalgi	# PEJVO例: koksalgi/o
kolazion	# PEJVO例: kolazion/i
kolc^ik	# PEJVO例: kolc^ik/o
kolc^ikin	# PEJVO例: kolc^ikin/o
koledok	# PEJVO例: koledok/o
kolh^oz	# PEJVO例: kolh^oz/o
kolimat	# PEJVO例: kolimat/i
kolokasi	# PEJVO例: kolokasi/o
kolokint	# PEJVO例: kolokint/o
kolombed	# PEJVO例: kolombed/oj
kolombi	# PEJVO例: kolombi/an/o
kolonj	# PEJVO例: kolonj/a akv/o
kolorometr	# PEJVO例: kolorometr/o
kolubred	# PEJVO例: kolubred/oj
kolĥoz	# PEJVO例: kolĥoz/an/o
koma	# PEJVO例: koma/o
komatul	# PEJVO例: komatul/o
komiks	# PEJVO例: komiks/o
komisur	# PEJVO例: komisur/o
komparativ	# PEJVO例: komparativ/o
kompensator	# PEJVO例: kompensator/o
kompiler	# PEJVO例: kompiler/i
kompos^t	# PEJVO例: kompos^t/i
kompozitac	# PEJVO例: kompozitac/oj
kompromit	# PEJVO例: kompromit/a
komutator	# PEJVO例: komutator/o
konced	# PEJVO例: konced/i
kondensator	# PEJVO例: kondensator/o
kondensor	# PEJVO例: kondensor/o
kondic^	# PEJVO例: kondic^/a
konfuce	# PEJVO例: konfuce/an/ism/o
konjunktivit	# PEJVO例: konjunktivit/o
kontag^	# PEJVO例: kontag^/a
kontau^	# PEJVO例: kontau^/a vent/o
kontratenor	# PEJVO例: kontratenor/o
kontrau^	# PEJVO例: kontrau^
kontrau^ supoz	# PEJVO例: kontrau^ supoz/o
kontrau^-	# PEJVO例: kontrau^-
kontrau^-manifestaci	# PEJVO例: kontrau^-manifestaci/o
kontribuci	# PEJVO例: kontribuci/o
konverg^	# PEJVO例: konverg^/a
konvers	# PEJVO例: konvers/i
konzern	# PEJVO例: konzern/o
konĉert	# PEJVO例: konĉert/o
korbikul	# PEJVO例: korbikul/o
korektur	# PEJVO例: korektur/o
korint	# PEJVO例: korint/ik/a
korintik	# PEJVO例: korintik/a kapitel/o
kornval	# PEJVO例: kornval/a
korsaj^	# PEJVO例: korsaj^/o
korsik	# PEJVO例: korsik/an/o
kos^	# PEJVO例: kos^/o
kos^er	# PEJVO例: kos^er/a
kosmolog	# PEJVO例: kosmolog/o
kosmologi	# PEJVO例: kosmologi/o
kosmonau^t	# PEJVO例: kosmonau^t/o
kosmonaŭt	# PEJVO例: kosmonaŭt/ik/o
kosmos	# PEJVO例: kosmos/o
kovard	# PEJVO例: kovard/a
koĉ	# PEJVO例: koĉ/o
koŝmar	# PEJVO例: koŝmar/o
krac^	# PEJVO例: krac^/ad/o
krampf	# PEJVO例: krampf/o
kraniometri	# PEJVO例: kraniometri/o
kras^	# PEJVO例: kras^/i
krau^l	# PEJVO例: krau^l/o
kresc^end	# PEJVO例: kresc^end/o
kretace	# PEJVO例: kretace/o
kric^	# PEJVO例: kric^/i
kriminal	# PEJVO例: kriminal/a
kriptomeri	# PEJVO例: kriptomeri/o
kriptoteni	# PEJVO例: kriptoteni/o
krist	# PEJVO例: krist/an/a
kristalograf	# PEJVO例: kristalograf/o
krit	# PEJVO例: krit/a
kroc^	# PEJVO例: kroc^/i
kroc^et	# PEJVO例: kroc^et/aj^/o
krom-	# PEJVO例: krom-
kromanjon	# PEJVO例: kromanjon/ul/o
kromi	# PEJVO例: kromi/o
kronograf	# PEJVO例: kronograf/i
kroĉ	# PEJVO例: kroĉ/ad/o
kruc^	# PEJVO例: kruc^/form/a korol/o
kuled	# PEJVO例: kuled/oj
kulmin-konferenc	# PEJVO例: kulmin-konferenc/o
kumulonimbus	# PEJVO例: kumulonimbus/o
kun-	# PEJVO例: kun-
kurag^	# PEJVO例: kurag^/a
kuri	# PEJVO例: kuri/o
kursor	# PEJVO例: kursor/o
kurtag^	# PEJVO例: kurtag^/o
kurtin	# PEJVO例: kurtin/o
kus^	# PEJVO例: kus^/a
kvalif	# PEJVO例: kvalif/i
kvar membr	# PEJVO例: kvar membr/oj
kvar mil	# PEJVO例: kvar mil
kvar sezon	# PEJVO例: kvar sezon/oj
kvar ver	# PEJVO例: kvar ver/oj
kvartet	# PEJVO例: kvartet/o
kvaternar	# PEJVO例: kvaternar/a
kvazau^	# PEJVO例: kvazau^
kvazau^-	# PEJVO例: kvazau^-
kvin mil	# PEJVO例: kvin mil
kvino	# PEJVO例: kvino/o
kvintet	# PEJVO例: kvintet/o
l'	# PEJVO例: l'
labiac	# PEJVO例: labiac/oj
labil	# PEJVO例: labil/a
labrador	# PEJVO例: labrador/a hund/o
lac^	# PEJVO例: lac^/i
ladin	# PEJVO例: ladin/a
lagenari	# PEJVO例: lagenari/o
lagerstrom	# PEJVO例: lagerstrom/o
lagri	# PEJVO例: lagri/o
lamark	# PEJVO例: lamark/ism/o
lanc^	# PEJVO例: lanc^/i
lanĉ	# PEJVO例: lanĉ/ad/o
laos	# PEJVO例: laos/a lingv/o
larg^	# PEJVO例: larg^/a
laringit	# PEJVO例: laringit/o
larĝ	# PEJVO例: larĝ/aĵ/o
lau^	# PEJVO例: lau^
lau^-	# PEJVO例: lau^-
lau^b	# PEJVO例: lau^b/o
lau^d	# PEJVO例: lau^d/i
lau^dan	# PEJVO例: lau^dan/o
lau^r	# PEJVO例: lau^r/ac/oj
lau^reat	# PEJVO例: lau^reat/o
lau^renti	# PEJVO例: lau^renti/o
lau^t	# PEJVO例: lau^t/a
lavab	# PEJVO例: lavab/o
laŭrenci	# PEJVO例: laŭrenci/o
laŭs	# PEJVO例: laŭs/o
lebanon	# PEJVO例: lebanon/a cedr/o
leg^	# PEJVO例: leg^/a
leg^er	# PEJVO例: leg^er/a
legac	# PEJVO例: legac/o
legitimaci	# PEJVO例: legitimaci/o
legumenac	# PEJVO例: legumenac/oj
leguminoz	# PEJVO例: leguminoz/oj
leksikologi	# PEJVO例: leksikologi/o
lepidodendr	# PEJVO例: lepidodendr/o
lepton	# PEJVO例: lepton/o
leu^kemi	# PEJVO例: leu^kemi/o
leu^kocit	# PEJVO例: leu^kocit/o
leu^komain	# PEJVO例: leu^komain/o
leu^kore	# PEJVO例: leu^kore/o
leu^s	# PEJVO例: leu^s/o
leu^tenant	# PEJVO例: leu^tenant/o
leŭcisk	# PEJVO例: leŭcisk/o
leŭg	# PEJVO例: leŭg/o
lias	# PEJVO例: lias/o
liban	# PEJVO例: liban/an/o
liberi	# PEJVO例: liberi/an/o
libi	# PEJVO例: libi/an/o
lid	# PEJVO例: lid/o
ligur	# PEJVO例: ligur/o
likopodiac	# PEJVO例: likopodiac/oj
likorid	# PEJVO例: likorid/o
liliput	# PEJVO例: liliput/a
limes	# PEJVO例: limes/o
limfangit	# PEJVO例: limfangit/o
linc^	# PEJVO例: linc^/ad/o
linear	# PEJVO例: linear/a ekvaci/o
linĉ	# PEJVO例: linĉ/o
liter-cifer	# PEJVO例: liter-cifer/a
literator	# PEJVO例: literator/o
livon	# PEJVO例: livon/o
liĉi	# PEJVO例: liĉi/arb/o
lobi	# PEJVO例: lobi/ad/o
lodikl	# PEJVO例: lodikl/o
loes	# PEJVO例: loes/o
log^	# PEJVO例: log^/ad/o
log^i	# PEJVO例: log^i/o
log^istik	# PEJVO例: log^istik/o
lokau^t	# PEJVO例: lokau^t/o
longobard	# PEJVO例: longobard/o
lotos	# PEJVO例: lotos/o
lozang^	# PEJVO例: lozang^/o
lozanĝ	# PEJVO例: lozanĝ/e
loĝ	# PEJVO例: loĝ/a
luciol	# PEJVO例: luciol/o
lug^	# PEJVO例: lug^/i
luksaci	# PEJVO例: luksaci/o
lumbalgi	# PEJVO例: lumbalgi/o
lumen	# PEJVO例: lumen/o
lunc^	# PEJVO例: lunc^/ej/o
lupen	# PEJVO例: lupen/o
luter	# PEJVO例: luter/an/ism/o
mac^	# PEJVO例: mac^/ad/o
macedon	# PEJVO例: macedon/o
macutak	# PEJVO例: macutak/o
madagaskar	# PEJVO例: madagaskar/a
mafi	# PEJVO例: mafi/o
mag^ang	# PEJVO例: mag^ang/o
magnetism	# PEJVO例: magnetism/o
magnitud	# PEJVO例: magnitud/o
mah^	# PEJVO例: mah^/nombr/o
mah^inaci	# PEJVO例: mah^inaci/o
mahajan	# PEJVO例: mahajan/o
maharaĝ	# PEJVO例: maharaĝ/o
mahomet	# PEJVO例: mahomet/an/o
mahoni	# PEJVO例: mahoni/o
maj^or	# PEJVO例: maj^or/a
makedoni	# PEJVO例: makedoni/an/o
makiavel	# PEJVO例: makiavel/a
makoli	# PEJVO例: makoli/o
mal-	# PEJVO例: mal-
mal-vort	# PEJVO例: mal-vort/o
malajzi	# PEJVO例: malajzi/an/o
malavi	# PEJVO例: malavi/an/o
maldiv	# PEJVO例: maldiv/an/o
malgrau^	# PEJVO例: malgrau^
malgrau^ ke	# PEJVO例: malgrau^ ke
malgrau^ tio	# PEJVO例: malgrau^ tio
mali	# PEJVO例: mali/an/o
malign	# PEJVO例: malign/a
maltaz	# PEJVO例: maltaz/o
maltoz	# PEJVO例: maltoz/o
maltus	# PEJVO例: maltus/an/a
maltusianism	# PEJVO例: maltusianism/o
mamografi	# PEJVO例: mamografi/o
mamon	# PEJVO例: mamon/ism/o
manc^ur	# PEJVO例: manc^ur/o
maneg^	# PEJVO例: maneg^/ej/o
mang^	# PEJVO例: mang^/ad/o
mang^u	# PEJVO例: mang^u/o
manipulator	# PEJVO例: manipulator/o
manj^u	# PEJVO例: manj^u/o
manĝ	# PEJVO例: manĝ/il/o
marc^	# PEJVO例: marc^/a irid/o
marc^and	# PEJVO例: marc^and/aj^/o
marg^en	# PEJVO例: marg^en/a
mari	# PEJVO例: mari/skarab/o
marih^uan	# PEJVO例: marih^uan/o
markist	# PEJVO例: markist/o
mars^	# PEJVO例: mars^/ad/i
mars^al	# PEJVO例: mars^al/o
marsupial	# PEJVO例: marsupial/oj
marĉ	# PEJVO例: marĉ/a
marĉand	# PEJVO例: marĉand/ad/o
mas^	# PEJVO例: mas^/ar/o
mas^in	# PEJVO例: mas^in/a
masag^	# PEJVO例: masag^/i
maser	# PEJVO例: maser/o
masoh^	# PEJVO例: masoh^/ism/o
mastrih^t	# PEJVO例: mastrih^t/a traktat/o
matc^	# PEJVO例: matc^/i
mau^r	# PEJVO例: mau^r/o
mau^rici	# PEJVO例: mau^rici/an/o
mau^ritani	# PEJVO例: mau^ritani/an/o
mau^zole	# PEJVO例: mau^zole/o
mav	# PEJVO例: mav/a
maĉ	# PEJVO例: maĉ/il/o
maĉet	# PEJVO例: maĉet/o
maĵor	# PEJVO例: maĵor/o
maŝin	# PEJVO例: maŝin/estr/o
maŭr	# PEJVO例: maŭr/a
mec^	# PEJVO例: mec^/aj^/o
mediterane	# PEJVO例: mediterane/aj land/oj
medolit	# PEJVO例: medolit/o
mega-	# PEJVO例: mega-
megalosau^r	# PEJVO例: megalosau^r/o
megavat	# PEJVO例: megavat/hor/o
meh^anik	# PEJVO例: meh^anik/o
meh^anism	# PEJVO例: meh^anism/o
meksik	# PEJVO例: meksik/an/o
meli	# PEJVO例: meli/o
melinit	# PEJVO例: melinit/o
mem-	# PEJVO例: mem-
menag^eri	# PEJVO例: menag^eri/o
mendel	# PEJVO例: mendel/ism/o
meningit	# PEJVO例: meningit/o
menopau^z	# PEJVO例: menopau^z/o
meretrik	# PEJVO例: meretrik/o
meringel	# PEJVO例: meringel/o
merkurokrom	# PEJVO例: merkurokrom/o
merluĉ	# PEJVO例: merluĉ/o
mesag^	# PEJVO例: mesag^/i
mesi	# PEJVO例: mesi/an/ism/o
metacentr	# PEJVO例: metacentr/o
metakarp	# PEJVO例: metakarp/o
metanol	# PEJVO例: metanol/o
metastabil	# PEJVO例: metastabil/a
metazo	# PEJVO例: metazo/oj
meteorism	# PEJVO例: meteorism/o
meteorolog	# PEJVO例: meteorolog/o
meteorologi	# PEJVO例: meteorologi/a bulten/o
metrologi	# PEJVO例: metrologi/o
metropol	# PEJVO例: metropol/o
mezalianc	# PEJVO例: mezalianc/o
mezozoik	# PEJVO例: mezozoik/o
miau^	# PEJVO例: miau^
migren	# PEJVO例: migren/o
mikro-	# PEJVO例: mikro-
mil paper	# PEJVO例: mil paper/gru/oj
mile	# PEJVO例: mile/o
mili-	# PEJVO例: mili-
milici	# PEJVO例: milici/o
miligram	# PEJVO例: miligram/o
milisivert	# PEJVO例: milisivert/o
militarism	# PEJVO例: militarism/o
militarist	# PEJVO例: militarist/o
mimik	# PEJVO例: mimik/i
mincikad	# PEJVO例: mincikad/o
minijup	# PEJVO例: minijup/o
miog	# PEJVO例: miog/o
mirag^	# PEJVO例: mirag^/o
miriametr	# PEJVO例: miriametr/o
mirmeleon	# PEJVO例: mirmeleon/o
mis-	# PEJVO例: mis-
misgurn	# PEJVO例: misgurn/o
miskant	# PEJVO例: miskant/o
miso	# PEJVO例: miso/o
mistif	# PEJVO例: mistif/i
mitolog	# PEJVO例: mitolog/o
mitomani	# PEJVO例: mitomani/o
mitridat	# PEJVO例: mitridat/ism/o
mjelit	# PEJVO例: mjelit/o
mnemoteknik	# PEJVO例: mnemoteknik/o
mo	# PEJVO例: mo
moc^i	# PEJVO例: moc^i/o
modjul	# PEJVO例: modjul/o
mogol	# PEJVO例: mogol/o
mokr	# PEJVO例: mokr/a
moks	# PEJVO例: moks/aj^/o
monah^	# PEJVO例: monah^/ej/o
monak	# PEJVO例: monak/ej/o
monarh^	# PEJVO例: monarh^/o
monarh^i	# PEJVO例: monarh^i/o
monaĥ	# PEJVO例: monaĥ/a
monokristal	# PEJVO例: monokristal/o
monokromat	# PEJVO例: monokromat/a
monokromator	# PEJVO例: monokromator/o
montenegr	# PEJVO例: montenegr/an/o
morgau^	# PEJVO例: morgau^
morh^el	# PEJVO例: morh^el/o
mos^t	# PEJVO例: mos^t/o
motocikl	# PEJVO例: motocikl/o
moŝt	# PEJVO例: moŝt/a
mu	# PEJVO例: mu
mug^	# PEJVO例: mug^/ad/o
mulc^	# PEJVO例: mulc^/i
multiplikend	# PEJVO例: multiplikend/o
munken	# PEJVO例: munken/ism/o
muon	# PEJVO例: muon/o
mus^	# PEJVO例: mus^/a amanit/o
musket	# PEJVO例: musket/ist/o
muĝ	# PEJVO例: muĝ/o
n-ro	# PEJVO例: n-ro
nacionalism	# PEJVO例: nacionalism/o
naftalin	# PEJVO例: naftalin/o
nag^	# PEJVO例: nag^/ad/o
namibi	# PEJVO例: namibi/an/o
nandin	# PEJVO例: nandin/a pom/et/o
nano-	# PEJVO例: nano-
nanosekund	# PEJVO例: nanosekund/o
narak	# PEJVO例: narak/o
narkotik	# PEJVO例: narkotik/o
narkoz	# PEJVO例: narkoz/o
naturalism	# PEJVO例: naturalism/o
naturalist	# PEJVO例: naturalist/o
naturaliz	# PEJVO例: naturaliz/i
nau^	# PEJVO例: nau^
nau^ mil	# PEJVO例: nau^ mil
nau^n	# PEJVO例: nau^n/o
nau^til	# PEJVO例: nau^til/o
nau^z	# PEJVO例: nau^z/a
navet	# PEJVO例: navet/o
navigaci	# PEJVO例: navigaci/i
naĝ	# PEJVO例: naĝ/a
ndlr	# PEJVO例: ndlr
ne jam	# PEJVO例: ne jam
ne mal	# PEJVO例: ne mal/pli
ne pli ol	# PEJVO例: ne pli ol
ne plu	# PEJVO例: ne plu
ne tut	# PEJVO例: ne tut/e
ne unu	# PEJVO例: ne unu
ne-esperant	# PEJVO例: ne-esperant/lingv/a
neandertal	# PEJVO例: neandertal/ul/o
nederland	# PEJVO例: nederland/a
neg^	# PEJVO例: neg^/a
neglig^	# PEJVO例: neglig^/a rob/o
neni	# PEJVO例: neni/aj^/o
nepal	# PEJVO例: nepal/a lingv/o
neri	# PEJVO例: neri/o
neu^ralgi	# PEJVO例: neu^ralgi/o
neu^rasteni	# PEJVO例: neu^rasteni/o
neu^rokirurgi	# PEJVO例: neu^rokirurgi/o
neu^rologi	# PEJVO例: neu^rologi/o
neu^ropter	# PEJVO例: neu^ropter/oj
neu^roz	# PEJVO例: neu^roz/a
neu^ton	# PEJVO例: neu^ton/a mekanik/o
neu^tr	# PEJVO例: neu^tr/a
neu^tral	# PEJVO例: neu^tral/a
neu^trin	# PEJVO例: neu^trin/o
neu^tron	# PEJVO例: neu^tron/a bomb/o
nevropter	# PEJVO例: nevropter/oj
neĝ	# PEJVO例: neĝ/as
neŭr	# PEJVO例: neŭr/asteni/a
neŭron	# PEJVO例: neŭron/o
nic^	# PEJVO例: nic^/o
nig^er	# PEJVO例: nig^er/an/o
nig^eri	# PEJVO例: nig^eri/an/o
nikab	# PEJVO例: nikab/o
nikel-kadmi	# PEJVO例: nikel-kadmi/a bateri/o
nikol	# PEJVO例: nikol/o
niktereu^t	# PEJVO例: niktereu^t/o
nimbostratus	# PEJVO例: nimbostratus/o
nimfomani	# PEJVO例: nimfomani/o
nipon	# PEJVO例: nipon/an/o
nitrat	# PEJVO例: nitrat/a acid/o
nitrid	# PEJVO例: nitrid/o
nitrit	# PEJVO例: nitrit/o
nitriz	# PEJVO例: nitriz/i
nitrobenzin	# PEJVO例: nitrobenzin/o
nitroglicerin	# PEJVO例: nitroglicerin/o
nj	# PEJVO例: nj/o-knab/o
no	# PEJVO例: no
noc^	# PEJVO例: noc^/baston/o
nokau^t	# PEJVO例: nokau^t/i
nombro	# PEJVO例: nombro/teori/o
nomogenez	# PEJVO例: nomogenez/o
norman	# PEJVO例: norman/o
nukleol	# PEJVO例: nukleol/o
nuklid	# PEJVO例: nuklid/o
nuton	# PEJVO例: nuton/o
o-vort	# PEJVO例: o-vort/o
obez	# PEJVO例: obez/a tinus/o
obskurantism	# PEJVO例: obskurantism/o
oc^j	# PEJVO例: oc^j/o
oficin	# PEJVO例: oficin/a
ofsajd	# PEJVO例: ofsajd/o
oho!	# PEJVO例: oho!
oj!	# PEJVO例: oj!
ok mil	# PEJVO例: ok mil
oktan	# PEJVO例: oktan/a nombr/o
okzalat	# PEJVO例: okzalat/a acid/o
oleac	# PEJVO例: oleac/oj
oligarh^	# PEJVO例: oligarh^/o
oligarh^i	# PEJVO例: oligarh^i/o
oligark	# PEJVO例: oligark/o
oligarki	# PEJVO例: oligarki/o
olimpi	# PEJVO例: olimpi/aj lud/oj
omag^	# PEJVO例: omag^/e al
omega	# PEJVO例: omega
onc^j	# PEJVO例: onc^j/o
ondometr	# PEJVO例: ondometr/o
ontogeni	# PEJVO例: ontogeni/o
opci	# PEJVO例: opci/o
operac	# PEJVO例: operac/o
oposum	# PEJVO例: oposum/o
optimum	# PEJVO例: optimum/o
orang^	# PEJVO例: orang^/aj^/o
orang^eri	# PEJVO例: orang^eri/o
oranĝ	# PEJVO例: oranĝ/a
ordinaci	# PEJVO例: ordinaci/o
ordovic	# PEJVO例: ordovic/o
ordovici	# PEJVO例: ordovici/o
orfe	# PEJVO例: orfe/ism/o
orientalism	# PEJVO例: orientalism/o
orientalist	# PEJVO例: orientalist/o
orientolog	# PEJVO例: orientolog/o
orientologi	# PEJVO例: orientologi/o
orkidit	# PEJVO例: orkidit/o
orsted	# PEJVO例: orsted/o
ortogenez	# PEJVO例: ortogenez/o
os-temp	# PEJVO例: os-temp/o
oscilator	# PEJVO例: oscilator/o
osmant	# PEJVO例: osmant/o
osmozometr	# PEJVO例: osmozometr/o
ostag^	# PEJVO例: ostag^/i
ostologi	# PEJVO例: ostologi/o
ostrogot	# PEJVO例: ostrogot/oj
otari	# PEJVO例: otari/o
ovoid	# PEJVO例: ovoid/a
p.	# PEJVO例: p.
p.K.	# PEJVO例: p.K.
pa!	# PEJVO例: pa!
pac^j	# PEJVO例: pac^j/o
pac^ul	# PEJVO例: pac^ul/o
paf'	# PEJVO例: paf'
pag^	# PEJVO例: pag^/numer/ad/o
pag^i	# PEJVO例: pag^i/o
pagr	# PEJVO例: pagr/o
pajn	# PEJVO例: pajn/o/s^alm/o
pakistan	# PEJVO例: pakistan/an/o
paled	# PEJVO例: paled/o
paleolitik	# PEJVO例: paleolitik/o
paleozoik	# PEJVO例: paleozoik/a
palestin	# PEJVO例: palestin/a problem/o
palmiped	# PEJVO例: palmiped/oj
panic	# PEJVO例: panic/a past/bul/o
pankreat	# PEJVO例: pankreat/o
papiliac	# PEJVO例: papiliac/oj
papilom	# PEJVO例: papilom/o
papu	# PEJVO例: papu/o
paramagnet	# PEJVO例: paramagnet/a
paras^ut	# PEJVO例: paras^ut/a
parazitologi	# PEJVO例: parazitologi/o
parfe	# PEJVO例: parfe/o
pariet	# PEJVO例: pariet/o
pariz	# PEJVO例: pariz/a
parkinson	# PEJVO例: parkinson/a mal/san/o
paroh^	# PEJVO例: paroh^/o
paroĥ	# PEJVO例: paroĥ/a
partikl	# PEJVO例: partikl/o
pas^	# PEJVO例: pas^/ad/o
pas^a	# PEJVO例: pas^a/ej/o
pas^t	# PEJVO例: pas^t/ad/o
pas^tel	# PEJVO例: pas^tel/a kolor/o
pasag^er	# PEJVO例: pasag^er/a kajut/o
pask	# PEJVO例: pask/a
paskal	# PEJVO例: paskal/o
pastec^	# PEJVO例: pastec^/o
pasteu^riz	# PEJVO例: pasteu^riz/i
pastic^	# PEJVO例: pastic^/i
patat	# PEJVO例: patat/o
patrini	# PEJVO例: patrini/o
pau^perism	# PEJVO例: pau^perism/o
pau^s	# PEJVO例: pau^s/aj^/o
pau^t	# PEJVO例: pau^t/i
pau^z	# PEJVO例: pau^z/i
paĝ	# PEJVO例: paĝ/ig/i
paĥiderm	# PEJVO例: paĥiderm/oj
paŝ	# PEJVO例: paŝ/ad/i
paŝt	# PEJVO例: paŝt/ist/a
paŝtel	# PEJVO例: paŝtel/a
paŭs	# PEJVO例: paŭs/o
pc^k	# PEJVO例: pc^k
pec^	# PEJVO例: pec^/a
pedofili	# PEJVO例: pedofili/o
pedologi	# PEJVO例: pedologi/o
peged	# PEJVO例: peged/oj
pejzag^	# PEJVO例: pejzag^/ist/o
pejzaĝ	# PEJVO例: pejzaĝ/a
pekin	# PEJVO例: pekin/a brasik/o
pelasg	# PEJVO例: pelasg/o
pelmel	# PEJVO例: pelmel/e
penal	# PEJVO例: penal/are/o
pentatom	# PEJVO例: pentatom/o
pep'	# PEJVO例: pep'
per si mem	# PEJVO例: per si mem
per-	# PEJVO例: per-
perc^	# PEJVO例: perc^/o
peri	# PEJVO例: peri/skop/o
perikard	# PEJVO例: perikard/o
perkol	# PEJVO例: perkol/ad/o
permanganat	# PEJVO例: permanganat/o
permeanc	# PEJVO例: permeanc/o
permi	# PEJVO例: permi/o
permitiv	# PEJVO例: permitiv/o
peroksid	# PEJVO例: peroksid/o
perpendikular	# PEJVO例: perpendikular/a
persi	# PEJVO例: persi/kari/o
peru	# PEJVO例: peru/an/o
perversi	# PEJVO例: perversi/o
pesticid	# PEJVO例: pesticid/o
petazit	# PEJVO例: petazit/a s^os/o
pic	# PEJVO例: pic/ej/o
pic^	# PEJVO例: pic^/o
piez	# PEJVO例: piez/o
pig^in	# PEJVO例: pig^in/a
pij^am	# PEJVO例: pij^am/o
piknometr	# PEJVO例: piknometr/o
piko	# PEJVO例: piko/farad/o
piko-	# PEJVO例: piko-
piktogram	# PEJVO例: piktogram/o
pikup	# PEJVO例: pikup/o
pilc^ard	# PEJVO例: pilc^ard/o
pinc^	# PEJVO例: pinc^/aj^/o
pind	# PEJVO例: pind/o
pingvin	# PEJVO例: pingvin/o
pinĉ	# PEJVO例: pinĉ/ad/o
pioc^	# PEJVO例: pioc^/i
pioĉ	# PEJVO例: pioĉ/et/o
pirheliometr	# PEJVO例: pirheliometr/o
piroelektr	# PEJVO例: piroelektr/a
piromagnet	# PEJVO例: piromagnet/a
pis^t	# PEJVO例: pis^t/o
pk.	# PEJVO例: pk.
plac^	# PEJVO例: plac^/a
plag^	# PEJVO例: plag^/o
plas	# PEJVO例: plas/i
platano	# PEJVO例: platano
plateno	# PEJVO例: plateno
platikodon	# PEJVO例: platikodon/o
platon	# PEJVO例: platon/a
plau^	# PEJVO例: plau^
plau^d	# PEJVO例: plau^d/ad/o
plaŭd	# PEJVO例: plaŭd/a
pleistocen	# PEJVO例: pleistocen/o
plej baldau^	# PEJVO例: plej baldau^
plej last	# PEJVO例: plej last/e
plej mal	# PEJVO例: plej mal/fru/e
pleu^r	# PEJVO例: pleu^r/o
pleu^rit	# PEJVO例: pleu^rit/o
pleu^ronekt	# PEJVO例: pleu^ronekt/ed/oj
pleŭronekt	# PEJVO例: pleŭronekt/o/form/aj
pli da	# PEJVO例: pli da
pli kaj pli	# PEJVO例: pli kaj pli
pli mal	# PEJVO例: pli mal/pli fru/e
pli ol	# PEJVO例: pli ol
pli preciz	# PEJVO例: pli preciz/e
pli-	# PEJVO例: pli-
pli-mal	# PEJVO例: pli-mal/pli
pli-ol-unu	# PEJVO例: pli-ol-unu
plong^	# PEJVO例: plong^/bomb/i
plus^	# PEJVO例: plus^/o
pluton	# PEJVO例: pluton/a
pluŝ	# PEJVO例: pluŝ/a
pm	# PEJVO例: pm
pneu^	# PEJVO例: pneu^/o
pneu^mat	# PEJVO例: pneu^mat/a pump/il/o
pneu^matik	# PEJVO例: pneu^matik/a
pneu^mokok	# PEJVO例: pneu^mokok/o
pneu^moni	# PEJVO例: pneu^moni/o
po-	# PEJVO例: po-
poc^	# PEJVO例: poc^/i
podkast	# PEJVO例: podkast/o
pok	# PEJVO例: pok/a
polaroid	# PEJVO例: polaroid/o
polenoz	# PEJVO例: polenoz/o
polent	# PEJVO例: polent/o
polietilen	# PEJVO例: polietilen/o
poligini	# PEJVO例: poligini/o
polinezi	# PEJVO例: polinezi/an/o
polipoz	# PEJVO例: polipoz/o
politolog	# PEJVO例: politolog/o
pomologi	# PEJVO例: pomologi/o
pong^e	# PEJVO例: pong^e/o
popart	# PEJVO例: popart/o
popmuzik	# PEJVO例: popmuzik/o
populaci	# PEJVO例: populaci/o
por c^iam	# PEJVO例: por c^iam
por etern	# PEJVO例: por etern/e
por ke	# PEJVO例: por ke
porn	# PEJVO例: porn/o
pos^	# PEJVO例: pos^/a
pos^t	# PEJVO例: pos^t/a
post Krist	# PEJVO例: post Krist/o
post kiam	# PEJVO例: post kiam
post-	# PEJVO例: post-
posthum	# PEJVO例: posthum/a
postic^	# PEJVO例: postic^/o
postiĉ	# PEJVO例: postiĉ/a
postpozici	# PEJVO例: postpozici/o
potag^	# PEJVO例: potag^/o
pou^p	# PEJVO例: pou^p/o
poziton	# PEJVO例: poziton/o
poŝt	# PEJVO例: poŝt/i
pra-	# PEJVO例: pra-
preg^	# PEJVO例: preg^/ar/o
premier	# PEJVO例: premier/o
premolar	# PEJVO例: premolar/o
preskau^	# PEJVO例: preskau^
preskau^ ne	# PEJVO例: preskau^ ne
prestidigitator	# PEJVO例: prestidigitator/o
prestig^	# PEJVO例: prestig^/a
preter-	# PEJVO例: preter-
prez.	# PEJVO例: prez.
preĝ	# PEJVO例: preĝ/a
pri-	# PEJVO例: pri-
prion	# PEJVO例: prion/o
pro-	# PEJVO例: pro-
procesor	# PEJVO例: procesor/o
produktiv	# PEJVO例: produktiv/a
prof.	# PEJVO例: prof.
prohib	# PEJVO例: prohib/i
prolegomen	# PEJVO例: prolegomen/o
proletari	# PEJVO例: proletari/o
propan	# PEJVO例: propan/gas/o
propedeu^tik	# PEJVO例: propedeu^tik/a
proskripci	# PEJVO例: proskripci/o
protokanajl	# PEJVO例: protokanajl/o
provincialism	# PEJVO例: provincialism/o
pseu^d	# PEJVO例: pseu^d/a
pseu^do	# PEJVO例: pseu^do/nom/o
pseu^do-	# PEJVO例: pseu^do-
pseu^donim	# PEJVO例: pseu^donim/o
pseŭdo	# PEJVO例: pseŭdo/cug/o
pseŭdonim	# PEJVO例: pseŭdonim/a
psikrometr	# PEJVO例: psikrometr/o
pteridi	# PEJVO例: pteridi/o
ptm.	# PEJVO例: ptm.
pu!	# PEJVO例: pu!
puaz	# PEJVO例: puaz/o
puc^	# PEJVO例: puc^/o
pulc^inel	# PEJVO例: pulc^inel/lud/o
punc^	# PEJVO例: punc^/o
pure	# PEJVO例: pure/o
pus^	# PEJVO例: pus^/ad/o
puŝ	# PEJVO例: puŝ/a
racionalism	# PEJVO例: racionalism/o
racionalist	# PEJVO例: racionalist/o
radial	# PEJVO例: radial/a
radiator	# PEJVO例: radiator/o
radio	# PEJVO例: radio/fot/o/grafi/o
radioaktiv	# PEJVO例: radioaktiv/a
radiograf	# PEJVO例: radiograf/ad/o
radiometr	# PEJVO例: radiometr/o
radioterapi	# PEJVO例: radioterapi/o
rag^	# PEJVO例: rag^/o
raj^a	# PEJVO例: raj^a/o
ramadan	# PEJVO例: ramadan/o
raned	# PEJVO例: raned/oj
ranunkolac	# PEJVO例: ranunkolac/oj
rapidometr	# PEJVO例: rapidometr/o
ratif	# PEJVO例: ratif/i
rau^k	# PEJVO例: rau^k/a
rau^nd	# PEJVO例: rau^nd/o
rau^p	# PEJVO例: rau^p/o
raŭp	# PEJVO例: raŭp/er/o
re-	# PEJVO例: re-
reaktanc	# PEJVO例: reaktanc/o
red.	# PEJVO例: red.
refleksologi	# PEJVO例: refleksologi/o
reformaci	# PEJVO例: reformaci/a mov/ad/o
reformator	# PEJVO例: reformator/o
refraktometr	# PEJVO例: refraktometr/o
reg^	# PEJVO例: reg^/a
reg^im	# PEJVO例: reg^im/klav/o
reg^isor	# PEJVO例: reg^isor/ad/o
regeneraci	# PEJVO例: regeneraci/o
regulator	# PEJVO例: regulator/o
rektif	# PEJVO例: rektif/i
rektumo	# PEJVO例: rektumo/skop/i/o
relaj	# PEJVO例: relaj/o
reluktanc	# PEJVO例: reluktanc/o
remanenc	# PEJVO例: remanenc/o
remi	# PEJVO例: remi/o
renesanc	# PEJVO例: renesanc/a
renga	# PEJVO例: renga/o
rentgen	# PEJVO例: rentgen/o
reologi	# PEJVO例: reologi/o
reporter	# PEJVO例: reporter/aj^/o
resolviv	# PEJVO例: resolviv/o
resonator	# PEJVO例: resonator/o
restau^r	# PEJVO例: restau^r/a fort/o
restaŭr	# PEJVO例: restaŭr/ad/o
resurekt	# PEJVO例: resurekt/i
resurs	# PEJVO例: resurs/o
retro-	# PEJVO例: retro-
retuŝ	# PEJVO例: retuŝ/o
reu^matism	# PEJVO例: reu^matism/o
reviz	# PEJVO例: reviz/i
reĝ	# PEJVO例: reĝ/e
ric^	# PEJVO例: ric^/a
riel	# PEJVO例: riel/o
rifug^	# PEJVO例: rifug^/ad/o
rikis^	# PEJVO例: rikis^/o
rikord	# PEJVO例: rikord/o
rilaks	# PEJVO例: rilaks/o
rim.	# PEJVO例: rim.
ringit	# PEJVO例: ringit/o
riproc^	# PEJVO例: riproc^/a
riĉ	# PEJVO例: riĉ/eg/a
rjo	# PEJVO例: rjo/o
ro	# PEJVO例: ro
rojalism	# PEJVO例: rojalism/o
rojalist	# PEJVO例: rojalist/o
rom	# PEJVO例: rom/a
roma	# PEJVO例: roma/a lingv/o
romanc^	# PEJVO例: romanc^/a lingv/o
romanĉ	# PEJVO例: romanĉ/a
romi	# PEJVO例: romi/a kod/o
rong^	# PEJVO例: rong^/i
ronĝ	# PEJVO例: ronĝ/ul/oj
rosin	# PEJVO例: rosin/o
rostbef	# PEJVO例: rostbef/o
rotari	# PEJVO例: rotari/an/o
rotator	# PEJVO例: rotator/o
ruditap	# PEJVO例: ruditap/o
rug^	# PEJVO例: rug^/a
rur	# PEJVO例: rur/o
rus^	# PEJVO例: rus^/o
ruten	# PEJVO例: ruten/o
ruĝ	# PEJVO例: ruĝ/aĵ/o
s-ano	# PEJVO例: s-ano
s-ino	# PEJVO例: s-ino
s-ro	# PEJVO例: s-ro
s.c.e.	# PEJVO例: s.c.e.
s^ablon	# PEJVO例: s^ablon/a
s^af	# PEJVO例: s^af/aj^/o
s^aft	# PEJVO例: s^aft/o
s^agrin	# PEJVO例: s^agrin/a
s^ah	# PEJVO例: s^ah/o
s^ajn	# PEJVO例: s^ajn/a
s^ak	# PEJVO例: s^ak/a
s^akal	# PEJVO例: s^akal/o
s^akr	# PEJVO例: s^akr/ad/o
s^akt	# PEJVO例: s^akt/o
s^al	# PEJVO例: s^al/et/o
s^alm	# PEJVO例: s^alm/o
s^alot	# PEJVO例: s^alot/o
s^alt	# PEJVO例: s^alt/i
s^alup	# PEJVO例: s^alup/o
s^am	# PEJVO例: s^am/o
s^aman	# PEJVO例: s^aman/ism/o
s^ampu	# PEJVO例: s^ampu/i
s^anc	# PEJVO例: s^anc/a
s^ancel	# PEJVO例: s^ancel/i
s^anel	# PEJVO例: s^anel/o
s^ang^	# PEJVO例: s^ang^/a
s^ankr	# PEJVO例: s^ankr/o
s^arad	# PEJVO例: s^arad/o
s^arg	# PEJVO例: s^arg/ad/o
s^arg^	# PEJVO例: s^arg^/a
s^arganc	# PEJVO例: s^arganc/o
s^arif	# PEJVO例: s^arif/o
s^ark	# PEJVO例: s^ark/o
s^at	# PEJVO例: s^at/at/a
s^au^m	# PEJVO例: s^au^m/a
s^au^r	# PEJVO例: s^au^r/o
s^ejk	# PEJVO例: s^ejk/o
s^el	# PEJVO例: s^el/aj^/o
s^elak	# PEJVO例: s^elak/o
s^elk	# PEJVO例: s^elk/eg/o
s^enopraz	# PEJVO例: s^enopraz/o
s^erc	# PEJVO例: s^erc/a
s^ere	# PEJVO例: s^ere/o
s^erif	# PEJVO例: s^erif/o
s^erp	# PEJVO例: s^erp/o
s^i	# PEJVO例: s^i
s^ijaism	# PEJVO例: s^ijaism/o
s^ijaist	# PEJVO例: s^ijaist/o
s^ik	# PEJVO例: s^ik/a
s^il	# PEJVO例: s^il/o
s^ild	# PEJVO例: s^ild/et/o
s^iling	# PEJVO例: s^iling/o
s^im	# PEJVO例: s^im/a
s^ind	# PEJVO例: s^ind/o
s^ink	# PEJVO例: s^ink/a sandvic^/o
s^into	# PEJVO例: s^into/a pastr/o
s^ip	# PEJVO例: s^ip/a
s^ir	# PEJVO例: s^ir/aj^/o
s^irm	# PEJVO例: s^irm/ad/o
s^itak	# PEJVO例: s^itak/o
s^kot	# PEJVO例: s^kot/o
s^lak	# PEJVO例: s^lak/o
s^lif	# PEJVO例: s^lif/i
s^lim	# PEJVO例: s^lim/a
s^los	# PEJVO例: s^los/ad/o
s^mac	# PEJVO例: s^mac/ad/o
s^mac'	# PEJVO例: s^mac'
s^mink	# PEJVO例: s^mink/ad/o
s^mir	# PEJVO例: s^mir/ad/o
s^nur	# PEJVO例: s^nur/arm/i
s^o	# PEJVO例: s^o
s^ofor	# PEJVO例: s^ofor/i
s^ok	# PEJVO例: s^ok/a
s^orbet	# PEJVO例: s^orbet/o
s^os	# PEJVO例: s^os/i
s^ose	# PEJVO例: s^ose/o
s^ot	# PEJVO例: s^ot/i
s^ov	# PEJVO例: s^ov/ebl/a
s^ovel	# PEJVO例: s^ovel/i
s^ovinism	# PEJVO例: s^ovinism/a
s^ovinist	# PEJVO例: s^ovinist/o
s^pal	# PEJVO例: s^pal/bolt/o
s^par	# PEJVO例: s^par/ad/o
s^pat	# PEJVO例: s^pat/i
s^pin	# PEJVO例: s^pin/ad/o
s^pruc	# PEJVO例: s^pruc/ad/o
s^pruc'	# PEJVO例: s^pruc'
s^pur	# PEJVO例: s^pur/o
s^rank	# PEJVO例: s^rank/o
s^rapnel	# PEJVO例: s^rapnel/o
s^rau^b	# PEJVO例: s^rau^b/aj^/o
s^rump	# PEJVO例: s^rump/i
s^s^	# PEJVO例: s^s^
s^tal	# PEJVO例: s^tal/a
s^tat	# PEJVO例: s^tat/a
s^tel	# PEJVO例: s^tel/ad/o
s^tip	# PEJVO例: s^tip/ar/o
s^tof	# PEJVO例: s^tof/o
s^ton	# PEJVO例: s^ton/a
s^top	# PEJVO例: s^top/aj^/o
s^torm	# PEJVO例: s^torm/a
s^trump	# PEJVO例: s^trump/et/o
s^tup	# PEJVO例: s^tup/a
s^u	# PEJVO例: s^u/bros/o
s^uld	# PEJVO例: s^uld/ant/a
s^ultr	# PEJVO例: s^ultr/a
s^unt	# PEJVO例: s^unt/i
s^ut	# PEJVO例: s^ut/ad/o
s^utr	# PEJVO例: s^utr/o
s^vab	# PEJVO例: s^vab/o
s^vabr	# PEJVO例: s^vabr/i
s^veb	# PEJVO例: s^veb/ad/o
s^vel	# PEJVO例: s^vel/aj^/o
s^vit	# PEJVO例: s^vit/a
saben	# PEJVO例: saben/o
sad	# PEJVO例: sad/ism/o
saduke	# PEJVO例: saduke/ism/o
sag^	# PEJVO例: sag^/a
sakaroz	# PEJVO例: sakaroz/o
sakur	# PEJVO例: sakur/o
same	# PEJVO例: same/o
sandvic^	# PEJVO例: sandvic^/o
sandviĉ	# PEJVO例: sandviĉ/ej/o
sansimon	# PEJVO例: sansimon/ism/o
sapor	# PEJVO例: sapor/i
sarmat	# PEJVO例: sarmat/o
sars	# PEJVO例: sars/o
satan	# PEJVO例: satan/a
satrapi	# PEJVO例: satrapi/o
saturn	# PEJVO例: saturn/ism/o
saturnali	# PEJVO例: saturnali/oj
sau^c	# PEJVO例: sau^c/aj^/o
sau^rkrau^t	# PEJVO例: sau^rkrau^t/o
savart	# PEJVO例: savart/o
sazank	# PEJVO例: sazank/o
saŭdad	# PEJVO例: saŭdad/o
saŭn	# PEJVO例: saŭn/o
saŭr	# PEJVO例: saŭr/o
scintil	# PEJVO例: scintil/ad/o
scit	# PEJVO例: scit/o
se ne	# PEJVO例: se ne
se neces	# PEJVO例: se neces/e
seg^	# PEJVO例: seg^/et/o
sejm	# PEJVO例: sejm/mars^al/o
sekulariz	# PEJVO例: sekulariz/i
sekvestraci	# PEJVO例: sekvestraci/i
sekvoj	# PEJVO例: sekvoj/o
senrju	# PEJVO例: senrju/o
sensac	# PEJVO例: sensac/o
sensualism	# PEJVO例: sensualism/o
sep mil	# PEJVO例: sep mil
serc^	# PEJVO例: serc^/ad/o
serg^	# PEJVO例: serg^/o
serg^ent	# PEJVO例: serg^ent/o
seriol	# PEJVO例: seriol/o
ses mil	# PEJVO例: ses mil
sest	# PEJVO例: sest/o
setari	# PEJVO例: setari/o
sferometr	# PEJVO例: sferometr/o
siberi	# PEJVO例: siberi/an/o
siderurgi	# PEJVO例: siderurgi/o
sieg^	# PEJVO例: sieg^/a
silikoz	# PEJVO例: silikoz/o
siluri	# PEJVO例: siluri/o
simens	# PEJVO例: simens/o
singulet	# PEJVO例: singulet/o
sinkrociklotron	# PEJVO例: sinkrociklotron/o
sionism	# PEJVO例: sionism/o
sirfed	# PEJVO例: sirfed/oj
siri	# PEJVO例: siri/a
sisirinki	# PEJVO例: sisirinki/o
sismologi	# PEJVO例: sismologi/o
siu	# PEJVO例: siu/o
sivert	# PEJVO例: sivert/o
skadron	# PEJVO例: skadron/o
skafark	# PEJVO例: skafark/o
skandinav	# PEJVO例: skandinav/o
skapolalgi	# PEJVO例: skapolalgi/o
skarif	# PEJVO例: skarif/i
skarol	# PEJVO例: skarol/o
skec^	# PEJVO例: skec^/o
ski-semajn	# PEJVO例: ski-semajn/o
skip	# PEJVO例: skip/estr/o
skit	# PEJVO例: skit/o
skleroz	# PEJVO例: skleroz/o
skrabl	# PEJVO例: skrabl/o
skurg^	# PEJVO例: skurg^/i
so	# PEJVO例: so
societ	# PEJVO例: societ/a
sodom	# PEJVO例: sodom/ism/o
softbal	# PEJVO例: softbal/o
sol-	# PEJVO例: sol-
solanac	# PEJVO例: solanac/oj
solfeĝ	# PEJVO例: solfeĝ/i
solidag	# PEJVO例: solidag/o
song^	# PEJVO例: song^/a
sonmetr	# PEJVO例: sonmetr/o
sorc^	# PEJVO例: sorc^/a
soroban	# PEJVO例: soroban/o
sorĉ	# PEJVO例: sorĉ/ad/o
sovag^	# PEJVO例: sovag^/a
sovag^-	# PEJVO例: sovag^-
soveti	# PEJVO例: soveti/a
spam	# PEJVO例: spam/ist/o
sparadrap	# PEJVO例: sparadrap/o
specifik	# PEJVO例: specifik/i
spektator	# PEJVO例: spektator/o
spektrograf	# PEJVO例: spektrograf/o
spektrogram	# PEJVO例: spektrogram/o
spektrometr	# PEJVO例: spektrometr/o
spektrometri	# PEJVO例: spektrometri/o
spermatozo	# PEJVO例: spermatozo/o
spinor	# PEJVO例: spinor/o
spinoz	# PEJVO例: spinoz/ism/o
spirant	# PEJVO例: spirant/o
spiritism	# PEJVO例: spiritism/a
spiritist	# PEJVO例: spiritist/o
spiritualism	# PEJVO例: spiritualism/o
spiritualist	# PEJVO例: spiritualist/o
spirogir	# PEJVO例: spirogir/o
sponsor	# PEJVO例: sponsor/ad/o
spontane	# PEJVO例: spontane/a
stabila ekvilibr	# PEJVO例: stabila ekvilibr/o
stadium	# PEJVO例: stadium/o
stag^	# PEJVO例: stag^/o
stam	# PEJVO例: stam/o
stampf	# PEJVO例: stampf/i
status	# PEJVO例: status/o
stau^d	# PEJVO例: stau^d/o
stau^l	# PEJVO例: stau^l/a angul/o
stereo	# PEJVO例: stereo/skop/i/o
stereofon	# PEJVO例: stereofon/o
steto	# PEJVO例: steto/skop/i
stilb	# PEJVO例: stilb/o
stirak	# PEJVO例: stirak/o
stomakit	# PEJVO例: stomakit/o
stor	# PEJVO例: stor/o
str.	# PEJVO例: str.
stratokumulus	# PEJVO例: stratokumulus/o
strec^	# PEJVO例: strec^/a
streĉ	# PEJVO例: streĉ/ad/o
strobo	# PEJVO例: strobo/skop/a fot/o
stuc	# PEJVO例: stuc/ad/o
stupa	# PEJVO例: stupa/o
sub mar	# PEJVO例: sub mar/nivel/o
sub-	# PEJVO例: sub-
suc^	# PEJVO例: suc^/botel/o
sudan	# PEJVO例: sudan/an/o
sufic^	# PEJVO例: sufic^/a
sufiksoid	# PEJVO例: sufiksoid/o
sufiĉ	# PEJVO例: sufiĉ/ec/o
sukavat	# PEJVO例: sukavat/o
sulfat	# PEJVO例: sulfat/a acid/o
sulfid	# PEJVO例: sulfid/o
sulfit	# PEJVO例: sulfit/o
sumer	# PEJVO例: sumer/o
sumo	# PEJVO例: sumo/ist/o
super mar	# PEJVO例: super mar/nivel/o
super-	# PEJVO例: super-
superpozici	# PEJVO例: superpozici/o
superstic^	# PEJVO例: superstic^/a
sur-	# PEJVO例: sur-
surinam	# PEJVO例: surinam/an/o
sus^i	# PEJVO例: sus^i/ej/o
susceptanc	# PEJVO例: susceptanc/o
susceptibl	# PEJVO例: susceptibl/a
suspensi	# PEJVO例: suspensi/aj^/o
suĉ	# PEJVO例: suĉ/ad/o
svazi	# PEJVO例: svazi/o
t.e.	# PEJVO例: t.e.
t.n.	# PEJVO例: t.n.
t.s.	# PEJVO例: t.s.
ta	# PEJVO例: ta/o/ist/o
tab	# PEJVO例: tab/o
tabi	# PEJVO例: tabi/o
tac^ment	# PEJVO例: tac^ment/i
tag^ik	# PEJVO例: tag^ik/o
tagalog	# PEJVO例: tagalog/a lingv/o
tajvan	# PEJVO例: tajvan/an/o
talib	# PEJVO例: talib/o
tamil	# PEJVO例: tamil/a lingv/o
tamul	# PEJVO例: tamul/o
tang^	# PEJVO例: tang^/ant/o
tanzani	# PEJVO例: tanzani/an/o
tanĝ	# PEJVO例: tanĝ/a
tapis^	# PEJVO例: tapis^/bomb/ad/o
tapiŝ	# PEJVO例: tapiŝ/ist/o
tartrat	# PEJVO例: tartrat/a acid/o
tatagat	# PEJVO例: tatagat/o
tatar	# PEJVO例: tatar/o
tau^g	# PEJVO例: tau^g/a
tau^r	# PEJVO例: tau^r/batal/o
tau^tologi	# PEJVO例: tau^tologi/o
tau^z	# PEJVO例: tau^z/et/i
taŭg	# PEJVO例: taŭg/as
taŭr	# PEJVO例: taŭr/a
taŭz	# PEJVO例: taŭz/ad/o
teh^nik	# PEJVO例: teh^nik/o
tekvond	# PEJVO例: tekvond/o
tele-	# PEJVO例: tele-
teleau^tograf	# PEJVO例: teleau^tograf/i
telefilm	# PEJVO例: telefilm/o
telekomand	# PEJVO例: telekomand/i
telematik	# PEJVO例: telematik/o
televid	# PEJVO例: televid/a
televizi	# PEJVO例: televizi/a
tempur	# PEJVO例: tempur/o
tenno	# PEJVO例: tenno/ism/o
tera-	# PEJVO例: tera-
terabajt	# PEJVO例: terabajt/o
terapeu^tik	# PEJVO例: terapeu^tik/a
teravad	# PEJVO例: teravad/o
teravat	# PEJVO例: teravat/hor/o
terciar	# PEJVO例: terciar/a
tesl	# PEJVO例: tesl/o
tetraon	# PEJVO例: tetraon/o
teu^ton	# PEJVO例: teu^ton/o
teĥnik	# PEJVO例: teĥnik/a
teŭton	# PEJVO例: teŭton/a
ti	# PEJVO例: ti/a/spec/a
tial, c^ar	# PEJVO例: tial, c^ar
tial, ke	# PEJVO例: tial, ke
tibet	# PEJVO例: tibet/an/o
tie kaj ali	# PEJVO例: tie kaj ali/lok/e
tie kaj c^i tie	# PEJVO例: tie kaj c^i tie
tie kaj tie	# PEJVO例: tie kaj tie
tiel nom	# PEJVO例: tiel nom/at/a
tifoid	# PEJVO例: tifoid/o
timpanit	# PEJVO例: timpanit/o
tio c^i	# PEJVO例: tio c^i
tio est	# PEJVO例: tio est/as
tiom mult	# PEJVO例: tiom mult/aj
tiu au^ ali	# PEJVO例: tiu au^ ali/a
tiu c^i	# PEJVO例: tiu c^i
tiu kaj tiu	# PEJVO例: tiu kaj tiu
tjurk	# PEJVO例: tjurk/aj lingv/oj
to	# PEJVO例: to
tofu	# PEJVO例: tofu/o
togol	# PEJVO例: togol/a
togoland	# PEJVO例: togoland/a
tohu	# PEJVO例: tohu/o
toki	# PEJVO例: toki/an/o
toksolog	# PEJVO例: toksolog/o
toksologi	# PEJVO例: toksologi/o
tomahau^k	# PEJVO例: tomahau^k/o
tong	# PEJVO例: tong/a
tonsilit	# PEJVO例: tonsilit/o
torc^	# PEJVO例: torc^/a procesi/o
toric^el	# PEJVO例: toric^el/a vaku/o
tortilj	# PEJVO例: tortilj/o
torĉ	# PEJVO例: torĉ/a
toskan	# PEJVO例: toskan/o
tou^fu	# PEJVO例: tou^fu/o
tra la fenestr	# PEJVO例: tra la fenestr/o
tra la mond	# PEJVO例: tra la mond/o
tra la nokt	# PEJVO例: tra la nokt/o
tra-	# PEJVO例: tra-
traduk-program	# PEJVO例: traduk-program/o
trah^e	# PEJVO例: trah^e/o
trah^eit	# PEJVO例: trah^eit/o
trah^eotomi	# PEJVO例: trah^eotomi/o
trakeit	# PEJVO例: trakeit/o
trakeotomi	# PEJVO例: trakeotomi/o
tranc^	# PEJVO例: tranc^/a
tranc^e	# PEJVO例: tranc^e/o
trans-	# PEJVO例: trans-
transformator	# PEJVO例: transformator/o
transmutaci	# PEJVO例: transmutaci/i
tranĉ	# PEJVO例: tranĉ/as
trap	# PEJVO例: trap/an/o
trapezoid	# PEJVO例: trapezoid/o
trau^b	# PEJVO例: trau^b/o
trau^m	# PEJVO例: trau^m/o
trau^mat	# PEJVO例: trau^mat/a
tri juvel	# PEJVO例: tri juvel/oj
tri mil	# PEJVO例: tri mil
tri primar	# PEJVO例: tri primar/aj kolor/oj
trias	# PEJVO例: trias/o
trih^in	# PEJVO例: trih^in/o
trikosant	# PEJVO例: trikosant/o
tripitak	# PEJVO例: tripitak/ul/o
triton	# PEJVO例: triton/o
tro-	# PEJVO例: tro-
trocki	# PEJVO例: trocki/ism/o
trofi	# PEJVO例: trofi/a nivel/o
troj	# PEJVO例: troj/an/o
tromboz	# PEJVO例: tromboz/o
trubadur	# PEJVO例: trubadur/o
tuareg	# PEJVO例: tuareg/o
tuberkulin	# PEJVO例: tuberkulin/a ekzamen/o
tuberkuloz	# PEJVO例: tuberkuloz/o
tuc^	# PEJVO例: tuc^/ad/o
tuj antau^	# PEJVO例: tuj antau^
tuj apud	# PEJVO例: tuj apud
tuj kiam	# PEJVO例: tuj kiam
tunizi	# PEJVO例: tunizi/an/o
turbul	# PEJVO例: turbul/a
turnir	# PEJVO例: turnir/i
tus^	# PEJVO例: tus^/ad/o
tut-	# PEJVO例: tut-
u-mod	# PEJVO例: u-mod/o
u^a	# PEJVO例: u^a
u^at	# PEJVO例: u^at/o
u^o	# PEJVO例: u^o
u^on	# PEJVO例: u^on/o
ukij	# PEJVO例: ukij/ist/o
ukrajn	# PEJVO例: ukrajn/an/o
ulamban	# PEJVO例: ulamban/o
ultra-	# PEJVO例: ultra-
umbelac	# PEJVO例: umbelac/oj
umbelifer	# PEJVO例: umbelifer/oj
undin	# PEJVO例: undin/o
unit	# PEJVO例: unit/a vektor/o
unu foj	# PEJVO例: unu foj/on por c^iam
unu la ali	# PEJVO例: unu la ali/an
unu post ali	# PEJVO例: unu post ali/a
urdu	# PEJVO例: urdu/a
ureat	# PEJVO例: ureat/a acid/o
urg^	# PEJVO例: urg^/a
urugvaj	# PEJVO例: urugvaj/an/o
uruŝi	# PEJVO例: uruŝi/i
urĝ	# PEJVO例: urĝ/ist/oj
us-mod	# PEJVO例: us-mod/o
uskl	# PEJVO例: uskl/ec/ignor/e
uson	# PEJVO例: uson/a
uzurpator	# PEJVO例: uzurpator/o
vac^	# PEJVO例: vac^/i
vaginism	# PEJVO例: vaginism/o
vaginit	# PEJVO例: vaginit/o
vajc	# PEJVO例: vajc/o
valah^	# PEJVO例: valah^/o
vareng	# PEJVO例: vareng/o
varsovi	# PEJVO例: varsovi/a
vasabi	# PEJVO例: vasabi/o
vatikan	# PEJVO例: vatikan/a
vav	# PEJVO例: vav/o
vd.	# PEJVO例: vd.
ve al	# PEJVO例: ve al
veber	# PEJVO例: veber/o
vegan	# PEJVO例: vegan/ism/o
vegetalin	# PEJVO例: vegetalin/o
vejnit	# PEJVO例: vejnit/o
venezuel	# PEJVO例: venezuel/an/o
veng^	# PEJVO例: veng^/a
venial	# PEJVO例: venial/a
venus	# PEJVO例: venus/har/a adiant/o
venĝ	# PEJVO例: venĝ/ad/o
vermic^el	# PEJVO例: vermic^el/o
vermiĉel	# PEJVO例: vermiĉel/oj
vers^	# PEJVO例: vers^/ad/o
vertig^	# PEJVO例: vertig^/i
vertiĝ	# PEJVO例: vertiĝ/o/don/a
verŝ	# PEJVO例: verŝ/ist/o
ves^t	# PEJVO例: ves^t/o
vesel	# PEJVO例: vesel/kapitan/o
vic-	# PEJVO例: vic-
viki	# PEJVO例: viki/o
vikipedi	# PEJVO例: vikipedi/ist/o
vilag^	# PEJVO例: vilag^/a
vinc^	# PEJVO例: vinc^/o
vinĉ	# PEJVO例: vinĉ/estr/o
violent	# PEJVO例: violent/a
violonc^el	# PEJVO例: violonc^el/i
violonĉel	# PEJVO例: violonĉel/uj/o
vir-	# PEJVO例: vir-
virulent	# PEJVO例: virulent/a
vis^	# PEJVO例: vis^/i
vistari	# PEJVO例: vistari/o
vizag^	# PEJVO例: vizag^/a
vizaĝ	# PEJVO例: vizaĝ/aĉ/o
viŝ	# PEJVO例: viŝ/ad/o
vo	# PEJVO例: vo
voc^	# PEJVO例: voc^/a
vojag^	# PEJVO例: vojag^/a
vojaĝ	# PEJVO例: vojaĝ/il/ar/o
vol.	# PEJVO例: vol.
volta	# PEJVO例: volta/a
vorcestr	# PEJVO例: vorcestr/a sau^c/o
zambi	# PEJVO例: zambi/an/o
zantoksil	# PEJVO例: zantoksil/o
zeŭgm	# PEJVO例: zeŭgm/o
zo	# PEJVO例: zo
zoogeografi	# PEJVO例: zoogeografi/o
zori	# PEJVO例: zori/o
zoroastr	# PEJVO例: zoroastr/ism/o
ĉaled	# PEJVO例: ĉaled/o
ĉampan	# PEJVO例: ĉampan/ig/i
ĉampinjon	# PEJVO例: ĉampinjon/o
ĉant	# PEJVO例: ĉant/i
ĉap	# PEJVO例: ĉap/et/o
ĉapel	# PEJVO例: ĉapel/ist/in/o
ĉardaŝ	# PEJVO例: ĉardaŝ/o
ĉarm	# PEJVO例: ĉarm/aĵ/o
ĉart	# PEJVO例: ĉart/ar/o
ĉast	# PEJVO例: ĉast/i
ĉatni	# PEJVO例: ĉatni/o
ĉatobriand	# PEJVO例: ĉatobriand/o
ĉek	# PEJVO例: ĉek/ar/o
ĉel	# PEJVO例: ĉel/a
ĉen	# PEJVO例: ĉen/et/o
ĉeriz	# PEJVO例: ĉeriz/ej/o
ĉeval	# PEJVO例: ĉeval/a
ĉiel	# PEJVO例: ĉiel/an/o
ĉifon	# PEJVO例: ĉifon/ar/o
ĉifĉaf	# PEJVO例: ĉifĉaf/o
ĉik	# PEJVO例: ĉik/o
ĉin	# PEJVO例: ĉin/o/log/o
ĉinĉil	# PEJVO例: ĉinĉil/o
ĉir	# PEJVO例: ĉir/o
ĉiz	# PEJVO例: ĉiz/ad/o
ĉizoj	# PEJVO例: ĉizoj/i
ĉiĉeron	# PEJVO例: ĉiĉeron/i
ĉokolad	# PEJVO例: ĉokolad/aĵ/o
ĉuk	# PEJVO例: ĉuk/o
ĉur	# PEJVO例: ĉur/i
ĝarden	# PEJVO例: ĝarden/i
ĝaz	# PEJVO例: ĝaz/o
ĝel	# PEJVO例: ĝel/ig/i
ĝem	# PEJVO例: ĝem/a
ĝemel	# PEJVO例: ĝemel/ig/i
ĝen	# PEJVO例: ĝen/ad/o
ĝeneral	# PEJVO例: ĝeneral/aĵ/o
ĝerm	# PEJVO例: ĝerm/ing/o
ĝerman	# PEJVO例: ĝerman/a
ĝib	# PEJVO例: ĝib/a
ĝigol	# PEJVO例: ĝigol/o
ĝimkan	# PEJVO例: ĝimkan/o
ĝir	# PEJVO例: ĝir/ebl/a
ĝis	# PEJVO例: ĝis/i
ĝu	# PEJVO例: ĝu/a
ĝust	# PEJVO例: ĝust/ig/a
ĥalde	# PEJVO例: ĥalde/a
ĥan	# PEJVO例: ĥan/ec/o
ĥaradri	# PEJVO例: ĥaradri/o
ĥeloni	# PEJVO例: ĥeloni/o
ĥimer	# PEJVO例: ĥimer/o/form/aj
ĥiton	# PEJVO例: ĥiton/o
ĥoler	# PEJVO例: ĥoler/a
ĥomer	# PEJVO例: ĥomer/o
ĥor	# PEJVO例: ĥor/a
ĥoral	# PEJVO例: ĥoral/o
ĵet	# PEJVO例: ĵet/ad/i
ĵur	# PEJVO例: ĵur/ad/i
ĵurnal	# PEJVO例: ĵurnal/ist/ik/o
ŝaf	# PEJVO例: ŝaf/a
ŝaft	# PEJVO例: ŝaft/ing/o
ŝajn	# PEJVO例: ŝajn/ig/ad/o
ŝak	# PEJVO例: ŝak/oj
ŝalt	# PEJVO例: ŝalt/ej/o
ŝamisen	# PEJVO例: ŝamisen/o
ŝampinjon	# PEJVO例: ŝampinjon/o
ŝancel	# PEJVO例: ŝancel/iĝ/o
ŝanĝ	# PEJVO例: ŝanĝ/ad/o
ŝark	# PEJVO例: ŝark/oj
ŝarĝ	# PEJVO例: ŝarĝ/ad/o
ŝat	# PEJVO例: ŝat/eg/i
ŝaŭm	# PEJVO例: ŝaŭm/aĵ/o
ŝel	# PEJVO例: ŝel/a
ŝer	# PEJVO例: ŝer/o
ŝik	# PEJVO例: ŝik/i
ŝim	# PEJVO例: ŝim/ig/i
ŝink	# PEJVO例: ŝink/et/o
ŝinto	# PEJVO例: ŝinto/an/o
ŝir	# PEJVO例: ŝir/ad/o
ŝirm	# PEJVO例: ŝirm/a
ŝlagr	# PEJVO例: ŝlagr/o
ŝlem	# PEJVO例: ŝlem/o
ŝlim	# PEJVO例: ŝlim/i
ŝlos	# PEJVO例: ŝlos/il/ar/o
ŝmink	# PEJVO例: ŝmink/ist/in/o
ŝmir	# PEJVO例: ŝmir/a
ŝnur	# PEJVO例: ŝnur/ad/o
ŝogun	# PEJVO例: ŝogun/o
ŝos	# PEJVO例: ŝos/et/o
ŝose	# PEJVO例: ŝose/a
ŝov	# PEJVO例: ŝov/iĝ/ad/o
ŝovel	# PEJVO例: ŝovel/ad/o
ŝpar	# PEJVO例: ŝpar/a
ŝpic	# PEJVO例: ŝpic/o
ŝpin	# PEJVO例: ŝpin/fask/o
ŝpruc	# PEJVO例: ŝpruc/a
ŝraŭb	# PEJVO例: ŝraŭb/a
ŝrump	# PEJVO例: ŝrump/ad/o
ŝtal	# PEJVO例: ŝtal/var/oj
ŝtern	# PEJVO例: ŝtern/o
ŝtip	# PEJVO例: ŝtip/ej/o
ŝtop	# PEJVO例: ŝtop/ad/o
ŝtrump	# PEJVO例: ŝtrump/o/ruband/o
ŝtup	# PEJVO例: ŝtup/ar/e
ŝu	# PEJVO例: ŝu/aĉ/oj
ŝuld	# PEJVO例: ŝuld/a
ŝunt	# PEJVO例: ŝunt/ad/o
ŝut	# PEJVO例: ŝut/aĵ/o
ŝvab	# PEJVO例: ŝvab/a
ŝveb	# PEJVO例: ŝveb/aĵ/o
ŝvel	# PEJVO例: ŝvel/a
ŝvit	# PEJVO例: ŝvit/ej/o
